Gene	cell_type
C12orf43	Astrocytes
C1orf53	Astrocytes
C16orf87	Astrocytes
KIAA1109	Astrocytes
KIAA0408	Astrocytes
C5orf15	Astrocytes
AAMP	Astrocytes
AATK	Astrocytes
ABCF1	Astrocytes
ABHD13	Astrocytes
ABHD14A	Astrocytes
ACOT7	Astrocytes
ACTR10	Astrocytes
ADAM22	Astrocytes
ADAR	Astrocytes
ADCYAP1R1	Astrocytes
ADGRB1	Astrocytes
ADGRB3	Astrocytes
ADGRL2	Astrocytes
ADPRH	Astrocytes
AFF3	Astrocytes
AGAP3	Astrocytes
AHI1	Astrocytes
AHSA1	Astrocytes
AKAP11	Astrocytes
ALDH1A1	Astrocytes
AMIGO1	Astrocytes
ANGPT1	Astrocytes
AP1S2	Astrocytes
AP2A2	Astrocytes
AP3B2	Astrocytes
APBB3	Astrocytes
APLP2	Astrocytes
APMAP	Astrocytes
APOE	Astrocytes
ARGLU1	Astrocytes
ARL6IP1	Astrocytes
ARL6IP5	Astrocytes
ARMCX5	Astrocytes
ARPC2	Astrocytes
ARPC4	Astrocytes
ATOX1	Astrocytes
ATP1B3	Astrocytes
ATP2B2	Astrocytes
ATP5F1A	Astrocytes
ATP5F1C	Astrocytes
ATP6V1A	Astrocytes
ATP6V1B2	Astrocytes
ATP6V1G2-DDX39B	Astrocytes
ATXN2L	Astrocytes
ATXN7L3B	Astrocytes
AZIN1	Astrocytes
C5orf24	Astrocytes
BACE1	Astrocytes
BAX	Astrocytes
C9orf78	Astrocytes
C18orf32	Astrocytes
BCAN	Astrocytes
BCAS2	Astrocytes
BCL6	Astrocytes
BCL7A	Astrocytes
BICRAL	Astrocytes
BMP6	Astrocytes
BNIP3L	Astrocytes
BRD9	Astrocytes
BRDT	Astrocytes
BRSK2	Astrocytes
BSG	Astrocytes
BTBD8	Astrocytes
BZW1	Astrocytes
BZW2	Astrocytes
C1D	Astrocytes
C1QL3	Astrocytes
CACHD1	Astrocytes
CACNA1A	Astrocytes
CACNA1D	Astrocytes
CACNB1	Astrocytes
CACNB2	Astrocytes
CADPS2	Astrocytes
CAMK2N1	Astrocytes
CAMTA1	Astrocytes
CAPNS1	Astrocytes
CAPZA2	Astrocytes
CA10	Astrocytes
CASC3	Astrocytes
CASD1	Astrocytes
CCDC25	Astrocytes
CCDC28A	Astrocytes
CCDC73	Astrocytes
CCT3	Astrocytes
CD81	Astrocytes
CDC37	Astrocytes
CDC42	Astrocytes
CDH13	Astrocytes
CDH4	Astrocytes
CDK17	Astrocytes
CDK5	Astrocytes
CDK9	Astrocytes
CELF2	Astrocytes
CELSR2	Astrocytes
CENPV	Astrocytes
CERS4	Astrocytes
CHCHD6	Astrocytes
CHMP1A	Astrocytes
RNF103-CHMP3	Astrocytes
CHMP3	Astrocytes
CHMP5	Astrocytes
CHN1	Astrocytes
CHST1	Astrocytes
CIT	Astrocytes
CLCN4	Astrocytes
CLDN10	Astrocytes
CLDND1	Astrocytes
CLTB	Astrocytes
CLTC	Astrocytes
CLU	Astrocytes
CMAS	Astrocytes
CNIH1	Astrocytes
CNTFR	Astrocytes
COA6	Astrocytes
COPB2	Astrocytes
COPE	Astrocytes
COPG1	Astrocytes
COX18	Astrocytes
COX7C	Astrocytes
COX8A	Astrocytes
CPNE8	Astrocytes
CPSF2	Astrocytes
CRELD1	Astrocytes
CRYM	Astrocytes
CSMD1	Astrocytes
CST3	Astrocytes
CTNNB1	Astrocytes
CTNNBIP1	Astrocytes
CTSB	Astrocytes
CTSD	Astrocytes
CUTA	Astrocytes
CWC25	Astrocytes
CYC1	Astrocytes
CYCS	Astrocytes
CYLD	Astrocytes
DAB2	Astrocytes
DAPK1	Astrocytes
DBI	Astrocytes
DBNL	Astrocytes
DCLK1	Astrocytes
DCTN1	Astrocytes
DCUN1D4	Astrocytes
DDRGK1	Astrocytes
DDX18	Astrocytes
DDX55	Astrocytes
DEGS1	Astrocytes
DEK	Astrocytes
DHRS7	Astrocytes
DIP2C	Astrocytes
DLG3	Astrocytes
DLGAP4	Astrocytes
DMXL2	Astrocytes
DNAJA2	Astrocytes
DNAJB6	Astrocytes
DNAJC10	Astrocytes
DNAJC30	Astrocytes
DNAJC5	Astrocytes
DNAJC8	Astrocytes
DNM3	Astrocytes
DOK6	Astrocytes
DOLK	Astrocytes
DPM2	Astrocytes
DPYSL2	Astrocytes
DRAP1	Astrocytes
DTD1	Astrocytes
DUSP16	Astrocytes
DYNC1I2	Astrocytes
DYNC1LI2	Astrocytes
DYNC2LI1	Astrocytes
EDF1	Astrocytes
EDNRB	Astrocytes
EEF1A1	Astrocytes
EEF1D	Astrocytes
EEF1G	Astrocytes
EGLN2	Astrocytes
EID1	Astrocytes
EID2B	Astrocytes
EIF1AX	Astrocytes
EIF2B5	Astrocytes
EIF2S2	Astrocytes
EIF3A	Astrocytes
EIF3E	Astrocytes
EIF3L	Astrocytes
EIF3M	Astrocytes
ELOC	Astrocytes
EMC1	Astrocytes
EPHA5	Astrocytes
EPN1	Astrocytes
EPRS1	Astrocytes
ERBB4	Astrocytes
ERF	Astrocytes
ERH	Astrocytes
ETNPPL	Astrocytes
EVA1A	Astrocytes
FAAP20	Astrocytes
FABP5	Astrocytes
FAHD1	Astrocytes
FAM107A	Astrocytes
FAM117B	Astrocytes
FAM126B	Astrocytes
FAM131A	Astrocytes
FAM171B	Astrocytes
FAM184A	Astrocytes
FAM214A	Astrocytes
FAM98B	Astrocytes
FARP1	Astrocytes
FBXO21	Astrocytes
FBXO34	Astrocytes
FBXO9	Astrocytes
FBXW7	Astrocytes
FEM1B	Astrocytes
FEZ1	Astrocytes
FGF14	Astrocytes
FH	Astrocytes
FILIP1L	Astrocytes
FKBP5	Astrocytes
FLYWCH1	Astrocytes
FOXP1	Astrocytes
FRY	Astrocytes
G3BP2	Astrocytes
GABARAP	Astrocytes
GABRG3	Astrocytes
GATD1	Astrocytes
GFOD1	Astrocytes
GID8	Astrocytes
GIPC1	Astrocytes
GJB6	Astrocytes
GLS	Astrocytes
GMFB	Astrocytes
GNA11	Astrocytes
GNL3L	Astrocytes
GPAM	Astrocytes
GPC6	Astrocytes
GPI	Astrocytes
GPRASP1	Astrocytes
GPS1	Astrocytes
GRIA1	Astrocytes
GRM3	Astrocytes
GRPEL1	Astrocytes
GSTM3	Astrocytes
GTF2F1	Astrocytes
GTF2H5	Astrocytes
HLA-E	Astrocytes
H3-3A	Astrocytes
HAGH	Astrocytes
HDAC2	Astrocytes
HGSNAT	Astrocytes
HIF3A	Astrocytes
HNRNPAB	Astrocytes
HNRNPD	Astrocytes
HNRNPH1	Astrocytes
HNRNPK	Astrocytes
HNRNPR	Astrocytes
HNRNPUL2-BSCL2	Astrocytes
HNRNPUL2	Astrocytes
HOMER1	Astrocytes
HP1BP3	Astrocytes
HS3ST3A1	Astrocytes
HSPA12A	Astrocytes
HSPA4	Astrocytes
HSPA5	Astrocytes
HSPA9	Astrocytes
HTATSF1	Astrocytes
ICE1	Astrocytes
IDH3G	Astrocytes
IFT22	Astrocytes
IGIP	Astrocytes
IK	Astrocytes
IL1RAPL1	Astrocytes
IMPA1	Astrocytes
INSYN1	Astrocytes
INTS1	Astrocytes
IRS2	Astrocytes
ITGAV	Astrocytes
ITGB1BP1	Astrocytes
ITM2B	Astrocytes
ITPR1	Astrocytes
IVNS1ABP	Astrocytes
JADE1	Astrocytes
JAGN1	Astrocytes
JOSD1	Astrocytes
KCND2	Astrocytes
KCNJ3	Astrocytes
KCNN3	Astrocytes
KCNQ3	Astrocytes
KCTD1	Astrocytes
KDELR2	Astrocytes
KHSRP	Astrocytes
KIF1A	Astrocytes
KIF2A	Astrocytes
KIF3A	Astrocytes
KIF3B	Astrocytes
KIFAP3	Astrocytes
KIZ	Astrocytes
KLC1	Astrocytes
KLF13	Astrocytes
KLHDC2	Astrocytes
KLHL2	Astrocytes
KLHL29	Astrocytes
KLHL7	Astrocytes
KLHL9	Astrocytes
KPNA1	Astrocytes
LAMP1	Astrocytes
LAMTOR1	Astrocytes
LAMTOR2	Astrocytes
LGALSL	Astrocytes
LMO4	Astrocytes
LMTK2	Astrocytes
LNPK	Astrocytes
LRP1B	Astrocytes
LRP4	Astrocytes
LRRC4	Astrocytes
LRRC45	Astrocytes
LRRC4C	Astrocytes
LSM14B	Astrocytes
LSM7	Astrocytes
M6PR	Astrocytes
MAF	Astrocytes
MAK16	Astrocytes
MAN2A1	Astrocytes
MAP2K1	Astrocytes
MAP2K6	Astrocytes
MAP7D1	Astrocytes
MAP7D2	Astrocytes
MAPK1	Astrocytes
MAPK4	Astrocytes
MAPK8IP1	Astrocytes
MARK1	Astrocytes
MAT2A	Astrocytes
MAT2B	Astrocytes
MATR3	Astrocytes
MBD3	Astrocytes
MCRIP1	Astrocytes
MCTS1	Astrocytes
ME3	Astrocytes
MEAF6	Astrocytes
MEF2C	Astrocytes
MEN1	Astrocytes
METTL23	Astrocytes
METTL9	Astrocytes
MFAP3L	Astrocytes
MGAT4C	Astrocytes
MGST1	Astrocytes
MID1IP1	Astrocytes
MINPP1	Astrocytes
MLEC	Astrocytes
MLF2	Astrocytes
MLLT6	Astrocytes
MORF4L1	Astrocytes
MPC2	Astrocytes
MPHOSPH8	Astrocytes
MPP2	Astrocytes
MRPL17	Astrocytes
MRPL27	Astrocytes
MRPL34	Astrocytes
MRPL55	Astrocytes
MRPS14	Astrocytes
MRPS16	Astrocytes
MRPS18B	Astrocytes
MRPS33	Astrocytes
MRTFB	Astrocytes
MSH2	Astrocytes
MT1G	Astrocytes
MTMR9	Astrocytes
MTPN	Astrocytes
MTX1	Astrocytes
MYEF2	Astrocytes
MYH6	Astrocytes
MYO18A	Astrocytes
N4BP1	Astrocytes
NAA10	Astrocytes
NAA25	Astrocytes
NAA50	Astrocytes
NACA	Astrocytes
NAP1L5	Astrocytes
NAPG	Astrocytes
NCAM2	Astrocytes
NCL	Astrocytes
NDFIP2	Astrocytes
NDUFA12	Astrocytes
NDUFA6	Astrocytes
NDUFA9	Astrocytes
NDUFB3	Astrocytes
NDUFB4	Astrocytes
NDUFS3	Astrocytes
NDUFV3	Astrocytes
NEXN	Astrocytes
NLGN3	Astrocytes
NOLC1	Astrocytes
NPDC1	Astrocytes
NRCAM	Astrocytes
NRG1	Astrocytes
NSF	Astrocytes
NSUN6	Astrocytes
NT5C2	Astrocytes
NTRK3	Astrocytes
NUDT19	Astrocytes
OAT	Astrocytes
OLA1	Astrocytes
OSBPL6	Astrocytes
OSGEP	Astrocytes
OSTC	Astrocytes
OXR1	Astrocytes
PAFAH1B1	Astrocytes
PAK1IP1	Astrocytes
PAM	Astrocytes
PAQR8	Astrocytes
PAX6	Astrocytes
PAXX	Astrocytes
PBX2	Astrocytes
PBX3	Astrocytes
PCDH10	Astrocytes
PCDH19	Astrocytes
PCLO	Astrocytes
PCYOX1	Astrocytes
PDE10A	Astrocytes
PDE1C	Astrocytes
PDE4B	Astrocytes
PDIA3	Astrocytes
PDZRN3	Astrocytes
PDZRN4	Astrocytes
PEG3	Astrocytes
PER1	Astrocytes
PER3	Astrocytes
PFDN4	Astrocytes
PHKB	Astrocytes
PHYHIPL	Astrocytes
PIM3	Astrocytes
PINK1	Astrocytes
PITPNM1	Astrocytes
PJA2	Astrocytes
PKIA	Astrocytes
PKP4	Astrocytes
PLCE1	Astrocytes
PLEKHA5	Astrocytes
PLEKHB2	Astrocytes
PLK4	Astrocytes
PLSCR4	Astrocytes
PMPCB	Astrocytes
PNPLA7	Astrocytes
POFUT2	Astrocytes
POLR2K	Astrocytes
POU3F4	Astrocytes
PPDPF	Astrocytes
PPM1G	Astrocytes
PPP1CC	Astrocytes
PPP1R11	Astrocytes
PPP1R13B	Astrocytes
PPP1R9A	Astrocytes
PPP2CA	Astrocytes
PPP2R2A	Astrocytes
PPP2R2B	Astrocytes
PPP2R2D	Astrocytes
PPP3CA	Astrocytes
PPP3CB	Astrocytes
PPT2-EGFL8	Astrocytes
PPT2	Astrocytes
PRDX1	Astrocytes
PRDX2	Astrocytes
PRELID3A	Astrocytes
PRICKLE1	Astrocytes
PRKCA	Astrocytes
PRKCE	Astrocytes
PRODH	Astrocytes
PRRC2B	Astrocytes
PSAP	Astrocytes
PSIP1	Astrocytes
PSMA2	Astrocytes
PSMA6	Astrocytes
PSMB1	Astrocytes
PSMB3	Astrocytes
PSMB7	Astrocytes
PSMD4	Astrocytes
PSMD6	Astrocytes
PSMD8	Astrocytes
PSMG4	Astrocytes
PTN	Astrocytes
PTOV1	Astrocytes
PTPN11	Astrocytes
PTPRJ	Astrocytes
PTPRT	Astrocytes
PURA	Astrocytes
PURB	Astrocytes
RAB1B	Astrocytes
TGIF2-RAB5IF	Astrocytes
RAB5IF	Astrocytes
RALY	Astrocytes
RASA1	Astrocytes
RBMS3	Astrocytes
RBX1	Astrocytes
RCE1	Astrocytes
RDH14	Astrocytes
RGS7	Astrocytes
RGS7BP	Astrocytes
RHEB	Astrocytes
RHOB	Astrocytes
RHOT2	Astrocytes
RIMS2	Astrocytes
RIPOR2	Astrocytes
RNF11	Astrocytes
RNF149	Astrocytes
RNMT	Astrocytes
RNPS1	Astrocytes
ROBO1	Astrocytes
ROBO2	Astrocytes
ROCK2	Astrocytes
RPL6	Astrocytes
RPP25L	Astrocytes
RSRP1	Astrocytes
RTF1	Astrocytes
RTF2	Astrocytes
RTRAF	Astrocytes
SALL3	Astrocytes
SAMD8	Astrocytes
SAMD9L	Astrocytes
SAR1A	Astrocytes
SARAF	Astrocytes
SCAMP1	Astrocytes
SCD	Astrocytes
SDE2	Astrocytes
SDHB	Astrocytes
SEC14L1	Astrocytes
SELENOS	Astrocytes
SEM1	Astrocytes
SERBP1	Astrocytes
SERINC3	Astrocytes
SF3B2	Astrocytes
SH3KBP1	Astrocytes
SHISA9	Astrocytes
SLC1A4	Astrocytes
SLC22A23	Astrocytes
SLC25A11	Astrocytes
SLC25A22	Astrocytes
SLC25A3	Astrocytes
SLC35C2	Astrocytes
SLC35F1	Astrocytes
SLC36A1	Astrocytes
SLC38A2	Astrocytes
SLC39A6	Astrocytes
SLC50A1	Astrocytes
SLC8A1	Astrocytes
SLCO1C1	Astrocytes
SMARCA5	Astrocytes
SMIM14	Astrocytes
SMOX	Astrocytes
SMPD1	Astrocytes
SNAPC1	Astrocytes
SNF8	Astrocytes
SNRPC	Astrocytes
SNRPD3	Astrocytes
SNRPE	Astrocytes
SNTB1	Astrocytes
SNTG2	Astrocytes
SOBP	Astrocytes
SOD1	Astrocytes
SOD2	Astrocytes
SORL1	Astrocytes
SOX12	Astrocytes
SOX9	Astrocytes
SPAG7	Astrocytes
SPEG	Astrocytes
SPIN1	Astrocytes
SPIRE1	Astrocytes
SPTAN1	Astrocytes
SPTSSA	Astrocytes
SRA1	Astrocytes
SRGAP1	Astrocytes
SRP19	Astrocytes
SRP72	Astrocytes
SRPK2	Astrocytes
SRPRA	Astrocytes
SRSF2	Astrocytes
SRSF3	Astrocytes
SRSF9	Astrocytes
SSBP2	Astrocytes
SSBP4	Astrocytes
SSR1	Astrocytes
STARD3	Astrocytes
STARD3NL	Astrocytes
STIP1	Astrocytes
STK25	Astrocytes
STRN	Astrocytes
STRN4	Astrocytes
STUB1	Astrocytes
STX16	Astrocytes
STX16-NPEPL1	Astrocytes
SUDS3	Astrocytes
SUGT1	Astrocytes
SULF1	Astrocytes
SYF2	Astrocytes
SYN3	Astrocytes
SYT11	Astrocytes
TAF13	Astrocytes
TBC1D24	Astrocytes
TBCA	Astrocytes
TBPL1	Astrocytes
TBRG1	Astrocytes
TCAF1	Astrocytes
TENM4	Astrocytes
TERF2IP	Astrocytes
TEX261	Astrocytes
TGOLN2	Astrocytes
TGS1	Astrocytes
THRA	Astrocytes
THRSP	Astrocytes
THSD4	Astrocytes
TIMM17A	Astrocytes
TIMM9	Astrocytes
TIMP3	Astrocytes
TLN2	Astrocytes
TM9SF3	Astrocytes
TMEFF1	Astrocytes
TMEM115	Astrocytes
TMEM131L	Astrocytes
TMEM176B	Astrocytes
TMEM178B	Astrocytes
TMEM184B	Astrocytes
TMEM222	Astrocytes
TMEM263	Astrocytes
TMEM63B	Astrocytes
TNFAIP8	Astrocytes
TOB2	Astrocytes
TPM1	Astrocytes
TRAPPC4	Astrocytes
TRMT6	Astrocytes
TP53BP2	Astrocytes
TRPM3	Astrocytes
TSC22D1	Astrocytes
TSC22D3	Astrocytes
TSNAX-DISC1	Astrocytes
TTC3	Astrocytes
TTC33	Astrocytes
TTL	Astrocytes
TUT4	Astrocytes
TXNRD1	Astrocytes
UAP1	Astrocytes
UBA2	Astrocytes
UBA52	Astrocytes
UBE2M	Astrocytes
UBE3A	Astrocytes
UBL3	Astrocytes
UBTF	Astrocytes
UBXN6	Astrocytes
UFC1	Astrocytes
UHMK1	Astrocytes
UNC13C	Astrocytes
UNC5C	Astrocytes
UNC79	Astrocytes
UPF1	Astrocytes
UQCRC1	Astrocytes
USP10	Astrocytes
USP14	Astrocytes
USP5	Astrocytes
USP53	Astrocytes
UST	Astrocytes
UTP14A	Astrocytes
UTP14C	Astrocytes
VAMP2	Astrocytes
VAPA	Astrocytes
VCAM1	Astrocytes
VCAN	Astrocytes
VCL	Astrocytes
VCP	Astrocytes
VDAC2	Astrocytes
VIM	Astrocytes
VOPP1	Astrocytes
VPS29	Astrocytes
VPS35	Astrocytes
WDR17	Astrocytes
WDR18	Astrocytes
WDR61	Astrocytes
XPC	Astrocytes
XPNPEP1	Astrocytes
YBX1	Astrocytes
YWHAE	Astrocytes
YWHAQ	Astrocytes
ZBTB18	Astrocytes
ZBTB7A	Astrocytes
ZC3H15	Astrocytes
ZCCHC17	Astrocytes
ZCRB1	Astrocytes
ZDHHC18	Astrocytes
ZNF280D	Astrocytes
ZMAT2	Astrocytes
ARF5	Interneurons_Chat+
C4orf3	Interneurons_Pnoc+
ABCC5	Interneurons_Pnoc+
ADARB2	Interneurons_Pnoc+
C11orf87	Interneurons_Pnoc+
AKAP5	Interneurons_Pnoc+
AMMECR1	Interneurons_Pnoc+
AP1S1	Interneurons_Pnoc+
AP2M1	Interneurons_Pnoc+
APOE	Interneurons_Pnoc+
ARF3	Interneurons_Pnoc+
ARGLU1	Interneurons_Pnoc+
ARHGAP22	Interneurons_Pnoc+
ARL6IP1	Interneurons_Pnoc+
ARPC1A	Interneurons_Pnoc+
ARPC5L	Interneurons_Pnoc+
ARPP19	Interneurons_Pnoc+
ARPP21	Interneurons_Pnoc+
ATP1B1	Interneurons_Pnoc+
ATP2A2	Interneurons_Pnoc+
ATP2B1	Interneurons_Pnoc+
ATP5F1B	Interneurons_Pnoc+
ATP5MF	Interneurons_Pnoc+
DONSON	Interneurons_Pnoc+
ATP5PO	Interneurons_Pnoc+
ATP6V0B	Interneurons_Pnoc+
ATP6V0C	Interneurons_Pnoc+
ATP6V1E1	Interneurons_Pnoc+
ATP6V1G1	Interneurons_Pnoc+
ATXN2L	Interneurons_Pnoc+
C5orf51	Interneurons_Pnoc+
BAG1	Interneurons_Pnoc+
BAIAP2	Interneurons_Pnoc+
BEX1	Interneurons_Pnoc+
BEX2	Interneurons_Pnoc+
BTAF1	Interneurons_Pnoc+
CACNA2D3	Interneurons_Pnoc+
CADM1	Interneurons_Pnoc+
CADM2	Interneurons_Pnoc+
CADPS2	Interneurons_Pnoc+
CALM2	Interneurons_Pnoc+
CAMK2A	Interneurons_Pnoc+
CAPZA2	Interneurons_Pnoc+
CATSPER2	Interneurons_Pnoc+
CCBE1	Interneurons_Pnoc+
CDH8	Interneurons_Pnoc+
CDH9	Interneurons_Pnoc+
CDK10	Interneurons_Pnoc+
CDK8	Interneurons_Pnoc+
CELF2	Interneurons_Pnoc+
CHL1	Interneurons_Pnoc+
CKB	Interneurons_Pnoc+
CLU	Interneurons_Pnoc+
CNTN4	Interneurons_Pnoc+
CNTNAP2	Interneurons_Pnoc+
COX14	Interneurons_Pnoc+
COX7C	Interneurons_Pnoc+
CPLX2	Interneurons_Pnoc+
CPNE7	Interneurons_Pnoc+
CREBZF	Interneurons_Pnoc+
CTSB	Interneurons_Pnoc+
CTTNBP2	Interneurons_Pnoc+
DCC	Interneurons_Pnoc+
DCHS2	Interneurons_Pnoc+
DCTN3	Interneurons_Pnoc+
DGKZ	Interneurons_Pnoc+
DLGAP1	Interneurons_Pnoc+
DNAJB11	Interneurons_Pnoc+
DSCAML1	Interneurons_Pnoc+
DTX3	Interneurons_Pnoc+
EDIL3	Interneurons_Pnoc+
EIF3C	Interneurons_Pnoc+
EIF3CL	Interneurons_Pnoc+
ENO1	Interneurons_Pnoc+
ERBB4	Interneurons_Pnoc+
ESD	Interneurons_Pnoc+
FAM219A	Interneurons_Pnoc+
FILIP1	Interneurons_Pnoc+
FKBP1C	Interneurons_Pnoc+
FKBP1A	Interneurons_Pnoc+
FSTL5	Interneurons_Pnoc+
FTH1	Interneurons_Pnoc+
FYCO1	Interneurons_Pnoc+
GABARAPL1	Interneurons_Pnoc+
GABRB2	Interneurons_Pnoc+
GMDS	Interneurons_Pnoc+
GOT1	Interneurons_Pnoc+
GPC6	Interneurons_Pnoc+
GPRIN3	Interneurons_Pnoc+
GRID2	Interneurons_Pnoc+
GRIK1	Interneurons_Pnoc+
GRIK2	Interneurons_Pnoc+
HINT1	Interneurons_Pnoc+
HMCN1	Interneurons_Pnoc+
HMGCR	Interneurons_Pnoc+
HNRNPA0	Interneurons_Pnoc+
HOMER1	Interneurons_Pnoc+
HS6ST3	Interneurons_Pnoc+
HSPH1	Interneurons_Pnoc+
ILDR2	Interneurons_Pnoc+
ITM2B	Interneurons_Pnoc+
ITPKA	Interneurons_Pnoc+
KALRN	Interneurons_Pnoc+
KCTD16	Interneurons_Pnoc+
KIFAP3	Interneurons_Pnoc+
LAMA3	Interneurons_Pnoc+
LAMP1	Interneurons_Pnoc+
LDHB	Interneurons_Pnoc+
LENG8	Interneurons_Pnoc+
LETM2	Interneurons_Pnoc+
LHX6	Interneurons_Pnoc+
LHX8	Interneurons_Pnoc+
LIN7B	Interneurons_Pnoc+
LINGO2	Interneurons_Pnoc+
LMO7	Interneurons_Pnoc+
LMTK3	Interneurons_Pnoc+
LRRC4C	Interneurons_Pnoc+
LRTM1	Interneurons_Pnoc+
LSAMP	Interneurons_Pnoc+
LZTS3	Interneurons_Pnoc+
MARCKS	Interneurons_Pnoc+
MBTD1	Interneurons_Pnoc+
MDH1	Interneurons_Pnoc+
MDH2	Interneurons_Pnoc+
MN1	Interneurons_Pnoc+
MRPL20	Interneurons_Pnoc+
MTX1	Interneurons_Pnoc+
MYEF2	Interneurons_Pnoc+
MYO5B	Interneurons_Pnoc+
NCL	Interneurons_Pnoc+
NDST4	Interneurons_Pnoc+
NDUFAB1	Interneurons_Pnoc+
NECAB1	Interneurons_Pnoc+
NFE2L1	Interneurons_Pnoc+
NLGN1	Interneurons_Pnoc+
NME7	Interneurons_Pnoc+
NOP10	Interneurons_Pnoc+
NPAS2	Interneurons_Pnoc+
NRGN	Interneurons_Pnoc+
OAZ1	Interneurons_Pnoc+
PARK7	Interneurons_Pnoc+
PAX6	Interneurons_Pnoc+
PCCA	Interneurons_Pnoc+
PCDH10	Interneurons_Pnoc+
PCSK1N	Interneurons_Pnoc+
PDIA6	Interneurons_Pnoc+
PDZD2	Interneurons_Pnoc+
PEG3	Interneurons_Pnoc+
PGRMC1	Interneurons_Pnoc+
PHACTR1	Interneurons_Pnoc+
PHKA1	Interneurons_Pnoc+
PISD	Interneurons_Pnoc+
PNMA8B	Interneurons_Pnoc+
POU6F2	Interneurons_Pnoc+
PPP3CA	Interneurons_Pnoc+
PPP3R1	Interneurons_Pnoc+
PRDX5	Interneurons_Pnoc+
PRMT8	Interneurons_Pnoc+
PSMA7	Interneurons_Pnoc+
PSMC3	Interneurons_Pnoc+
PTMS	Interneurons_Pnoc+
PTN	Interneurons_Pnoc+
PTPRD	Interneurons_Pnoc+
R3HDM1	Interneurons_Pnoc+
RAP2B	Interneurons_Pnoc+
RASGRP2	Interneurons_Pnoc+
ROBO1	Interneurons_Pnoc+
RPL22L1	Interneurons_Pnoc+
RREB1	Interneurons_Pnoc+
RSRP1	Interneurons_Pnoc+
RXFP1	Interneurons_Pnoc+
SAMD5	Interneurons_Pnoc+
SARAF	Interneurons_Pnoc+
SCD	Interneurons_Pnoc+
SCG2	Interneurons_Pnoc+
SELENOF	Interneurons_Pnoc+
SELENOW	Interneurons_Pnoc+
SH3GLB2	Interneurons_Pnoc+
SLC24A5	Interneurons_Pnoc+
SLC35B3	Interneurons_Pnoc+
SLC38A2	Interneurons_Pnoc+
SLIT3	Interneurons_Pnoc+
SON	Interneurons_Pnoc+
SOX5	Interneurons_Pnoc+
SRSF10	Interneurons_Pnoc+
SRSF2	Interneurons_Pnoc+
SRSF5	Interneurons_Pnoc+
SRSF7	Interneurons_Pnoc+
STK31	Interneurons_Pnoc+
STX1B	Interneurons_Pnoc+
SYNDIG1	Interneurons_Pnoc+
TCF4	Interneurons_Pnoc+
TGOLN2	Interneurons_Pnoc+
TIMM8B	Interneurons_Pnoc+
TIMP2	Interneurons_Pnoc+
TM2D3	Interneurons_Pnoc+
TMA7	Interneurons_Pnoc+
TMEM163	Interneurons_Pnoc+
TMX2	Interneurons_Pnoc+
TOMM70	Interneurons_Pnoc+
TRANK1	Interneurons_Pnoc+
TTC19	Interneurons_Pnoc+
UBXN1	Interneurons_Pnoc+
UQCRH	Interneurons_Pnoc+
UQCRHL	Interneurons_Pnoc+
VAMP2	Interneurons_Pnoc+
VDAC2	Interneurons_Pnoc+
VWC2L	Interneurons_Pnoc+
YWHAB	Interneurons_Pnoc+
YWHAH	Interneurons_Pnoc+
ZMAT2	Interneurons_Pnoc+
C11orf87	Interneurons_Pvalb+
ANO3	Interneurons_Pvalb+
AP2M1	Interneurons_Pvalb+
ARF3	Interneurons_Pvalb+
ARPC1A	Interneurons_Pvalb+
ARPC5L	Interneurons_Pvalb+
ARPP21	Interneurons_Pvalb+
ATP5F1B	Interneurons_Pvalb+
ATP6V0C	Interneurons_Pvalb+
ATP6V1D	Interneurons_Pvalb+
ATP6V1E1	Interneurons_Pvalb+
ATXN7	Interneurons_Pvalb+
CAMK2B	Interneurons_Pvalb+
CANX	Interneurons_Pvalb+
CAPZA2	Interneurons_Pvalb+
CLTA	Interneurons_Pvalb+
COPB2	Interneurons_Pvalb+
COX6A1	Interneurons_Pvalb+
COX7C	Interneurons_Pvalb+
CREB5	Interneurons_Pvalb+
CTSB	Interneurons_Pvalb+
DYNLL2	Interneurons_Pvalb+
FBXL16	Interneurons_Pvalb+
FILIP1	Interneurons_Pvalb+
FKBP1C	Interneurons_Pvalb+
FKBP1A	Interneurons_Pvalb+
GK	Interneurons_Pvalb+
GK3P	Interneurons_Pvalb+
GNAL	Interneurons_Pvalb+
GRINA	Interneurons_Pvalb+
H3-3A	Interneurons_Pvalb+
HNRNPA0	Interneurons_Pvalb+
HSPH1	Interneurons_Pvalb+
IDUA	Interneurons_Pvalb+
INTS3	Interneurons_Pvalb+
KCNIP2	Interneurons_Pvalb+
KLF9	Interneurons_Pvalb+
LAMP1	Interneurons_Pvalb+
LMO7	Interneurons_Pvalb+
LRPAP1	Interneurons_Pvalb+
MARCKS	Interneurons_Pvalb+
MDH2	Interneurons_Pvalb+
MRPL20	Interneurons_Pvalb+
MSMO1	Interneurons_Pvalb+
MYL6	Interneurons_Pvalb+
NAP1L1	Interneurons_Pvalb+
NCL	Interneurons_Pvalb+
NDFIP1	Interneurons_Pvalb+
NDN	Interneurons_Pvalb+
NDRG2	Interneurons_Pvalb+
NDRG4	Interneurons_Pvalb+
NDUFB2	Interneurons_Pvalb+
NDUFB9	Interneurons_Pvalb+
NRG2	Interneurons_Pvalb+
NUCKS1	Interneurons_Pvalb+
OAZ1	Interneurons_Pvalb+
PCP4L1	Interneurons_Pvalb+
PCSK1N	Interneurons_Pvalb+
PDCD6	Interneurons_Pvalb+
PDIA6	Interneurons_Pvalb+
PIGK	Interneurons_Pvalb+
PPP1R2	Interneurons_Pvalb+
PPP1R2B	Interneurons_Pvalb+
PPP3CA	Interneurons_Pvalb+
PSENEN	Interneurons_Pvalb+
PSMA7	Interneurons_Pvalb+
PTN	Interneurons_Pvalb+
RAB14	Interneurons_Pvalb+
RAB40B	Interneurons_Pvalb+
RASGRP2	Interneurons_Pvalb+
REEP5	Interneurons_Pvalb+
RRP1	Interneurons_Pvalb+
SARAF	Interneurons_Pvalb+
SCD	Interneurons_Pvalb+
SCLY	Interneurons_Pvalb+
SCN2B	Interneurons_Pvalb+
SELENOF	Interneurons_Pvalb+
SLC25A27	Interneurons_Pvalb+
SSH2	Interneurons_Pvalb+
STMN1	Interneurons_Pvalb+
SYT11	Interneurons_Pvalb+
SYT14	Interneurons_Pvalb+
THRA	Interneurons_Pvalb+
TMA7	Interneurons_Pvalb+
TOMM70	Interneurons_Pvalb+
TTC37	Interneurons_Pvalb+
UQCRH	Interneurons_Pvalb+
UQCRHL	Interneurons_Pvalb+
WASF1	Interneurons_Pvalb+
YWHAB	Interneurons_Pvalb+
ARF3	Interneurons_Sst+
ARPC1A	Interneurons_Sst+
ARPP21	Interneurons_Sst+
ATP5F1B	Interneurons_Sst+
ATP6V0C	Interneurons_Sst+
BAIAP2	Interneurons_Sst+
BSG	Interneurons_Sst+
CAMK2B	Interneurons_Sst+
CA11	Interneurons_Sst+
CD81	Interneurons_Sst+
CLU	Interneurons_Sst+
COX14	Interneurons_Sst+
CPLX2	Interneurons_Sst+
CPNE5	Interneurons_Sst+
CTSB	Interneurons_Sst+
ENO1	Interneurons_Sst+
FKBP1C	Interneurons_Sst+
FKBP1A	Interneurons_Sst+
FKBP8	Interneurons_Sst+
FOXP1	Interneurons_Sst+
FTH1	Interneurons_Sst+
KCNIP2	Interneurons_Sst+
LZTS3	Interneurons_Sst+
NDRG4	Interneurons_Sst+
NDUFV1	Interneurons_Sst+
NGEF	Interneurons_Sst+
PCSK1N	Interneurons_Sst+
PPP1R2	Interneurons_Sst+
PPP1R2B	Interneurons_Sst+
RPS15	Interneurons_Sst+
SARAF	Interneurons_Sst+
SNCA	Interneurons_Sst+
SV2B	Interneurons_Sst+
TIMP2	Interneurons_Sst+
UQCRH	Interneurons_Sst+
UQCRHL	Interneurons_Sst+
WASF1	Interneurons_Sst+
YWHAB	Interneurons_Sst+
YWHAH	Interneurons_Sst+
ABCC5	Interneurons_Th+
ACTN2	Interneurons_Th+
C11orf87	Interneurons_Th+
AMMECR1	Interneurons_Th+
ANO3	Interneurons_Th+
AP2M1	Interneurons_Th+
ARF3	Interneurons_Th+
ARF5	Interneurons_Th+
ARHGEF12	Interneurons_Th+
ARL6IP1	Interneurons_Th+
ARPC1A	Interneurons_Th+
ARPC3	Interneurons_Th+
ARPC5L	Interneurons_Th+
ARPP21	Interneurons_Th+
SPCS3	Interneurons_Th+
ATP2A2	Interneurons_Th+
ATP2B1	Interneurons_Th+
ATP5F1B	Interneurons_Th+
ATP5PD	Interneurons_Th+
ATP6V0C	Interneurons_Th+
ATP6V1D	Interneurons_Th+
ATP6V1E1	Interneurons_Th+
BAG1	Interneurons_Th+
BAIAP2	Interneurons_Th+
BEX3	Interneurons_Th+
BOLA1	Interneurons_Th+
BRK1	Interneurons_Th+
BSG	Interneurons_Th+
CALM2	Interneurons_Th+
CALM3	Interneurons_Th+
CALY	Interneurons_Th+
CAMK2B	Interneurons_Th+
CAMKV	Interneurons_Th+
CAPZA2	Interneurons_Th+
CCSAP	Interneurons_Th+
CCT2	Interneurons_Th+
CCT7	Interneurons_Th+
CD81	Interneurons_Th+
CDC37	Interneurons_Th+
CDK17	Interneurons_Th+
CELF3	Interneurons_Th+
CHMP2A	Interneurons_Th+
CHPF2	Interneurons_Th+
CKB	Interneurons_Th+
CLTA	Interneurons_Th+
CLU	Interneurons_Th+
COX6A1	Interneurons_Th+
COX7A2	Interneurons_Th+
COX7C	Interneurons_Th+
CPLX2	Interneurons_Th+
CPNE5	Interneurons_Th+
CSNK1D	Interneurons_Th+
CTSB	Interneurons_Th+
DDX24	Interneurons_Th+
DGKB	Interneurons_Th+
DMXL1	Interneurons_Th+
DYNLL2	Interneurons_Th+
EIF3C	Interneurons_Th+
EIF3CL	Interneurons_Th+
ENO1	Interneurons_Th+
ENTR1	Interneurons_Th+
FAM135A	Interneurons_Th+
FKBP1C	Interneurons_Th+
FKBP1A	Interneurons_Th+
FKBP8	Interneurons_Th+
FOXP1	Interneurons_Th+
GABRD	Interneurons_Th+
GNAL	Interneurons_Th+
GNB2	Interneurons_Th+
GNL1	Interneurons_Th+
GNPAT	Interneurons_Th+
GPR26	Interneurons_Th+
H3-3A	Interneurons_Th+
HNRNPA0	Interneurons_Th+
HSPH1	Interneurons_Th+
KCNA4	Interneurons_Th+
KCNIP2	Interneurons_Th+
KCTD1	Interneurons_Th+
KIF22	Interneurons_Th+
KLF9	Interneurons_Th+
LAMP1	Interneurons_Th+
LMTK3	Interneurons_Th+
LRPAP1	Interneurons_Th+
LYRM2	Interneurons_Th+
LYRM4	Interneurons_Th+
LZTS3	Interneurons_Th+
MAP1A	Interneurons_Th+
MARCKS	Interneurons_Th+
MAZ	Interneurons_Th+
MDH2	Interneurons_Th+
MRPL17	Interneurons_Th+
MYL6	Interneurons_Th+
NAP1L1	Interneurons_Th+
NCL	Interneurons_Th+
NDFIP1	Interneurons_Th+
NDN	Interneurons_Th+
NDRG4	Interneurons_Th+
NDUFA4	Interneurons_Th+
NDUFB2	Interneurons_Th+
NDUFV1	Interneurons_Th+
NLGN3	Interneurons_Th+
NME7	Interneurons_Th+
NPTXR	Interneurons_Th+
OAZ1	Interneurons_Th+
OSBPL7	Interneurons_Th+
PCSK1N	Interneurons_Th+
PDAP1	Interneurons_Th+
PDCD6	Interneurons_Th+
PDIA6	Interneurons_Th+
PDXP	Interneurons_Th+
PER1	Interneurons_Th+
PGK1	Interneurons_Th+
PGRMC1	Interneurons_Th+
PHACTR1	Interneurons_Th+
PPP1R2	Interneurons_Th+
PPP1R2B	Interneurons_Th+
PPP3CA	Interneurons_Th+
PPP6R1	Interneurons_Th+
PRAF2	Interneurons_Th+
PRKAR1A	Interneurons_Th+
PSENEN	Interneurons_Th+
PSMA7	Interneurons_Th+
PSMC3	Interneurons_Th+
PSMC4	Interneurons_Th+
PTMS	Interneurons_Th+
PTN	Interneurons_Th+
PTPN1	Interneurons_Th+
PTPN5	Interneurons_Th+
RAB14	Interneurons_Th+
REEP5	Interneurons_Th+
RGS10	Interneurons_Th+
ROBO1	Interneurons_Th+
ROCK1	Interneurons_Th+
RPL22L1	Interneurons_Th+
RPS20	Interneurons_Th+
RRAGD	Interneurons_Th+
RRP1	Interneurons_Th+
RTN1	Interneurons_Th+
RTN4	Interneurons_Th+
SARAF	Interneurons_Th+
SCD	Interneurons_Th+
SCG2	Interneurons_Th+
SELENOF	Interneurons_Th+
SEZ6	Interneurons_Th+
SFMBT1	Interneurons_Th+
SLC1A3	Interneurons_Th+
SLC25A14	Interneurons_Th+
SMPD3	Interneurons_Th+
SNCA	Interneurons_Th+
SORL1	Interneurons_Th+
STRN	Interneurons_Th+
TCEAL5	Interneurons_Th+
TCEAL3	Interneurons_Th+
TCEAL6	Interneurons_Th+
TCEAL9	Interneurons_Th+
TFRC	Interneurons_Th+
THRA	Interneurons_Th+
TIMP2	Interneurons_Th+
TM2D2	Interneurons_Th+
TMA7	Interneurons_Th+
TMEM130	Interneurons_Th+
TMSB4Y	Interneurons_Th+
TMX4	Interneurons_Th+
TOMM70	Interneurons_Th+
TPI1	Interneurons_Th+
TPRG1L	Interneurons_Th+
TRRAP	Interneurons_Th+
TUBA1A	Interneurons_Th+
UBB	Interneurons_Th+
UBR2	Interneurons_Th+
UCHL1	Interneurons_Th+
UQCRH	Interneurons_Th+
UQCRHL	Interneurons_Th+
UQCRQ	Interneurons_Th+
WASF1	Interneurons_Th+
YPEL2	Interneurons_Th+
NCBP2AS2	Microglia
C17orf75	Microglia
ABLIM1	Microglia
ACTR10	Microglia
ACTR6	Microglia
ADGRL2	Microglia
ADRB1	Microglia
AKAP1	Microglia
AMD1	Microglia
ANAPC2	Microglia
APOE	Microglia
AREL1	Microglia
ATG13	Microglia
ATG16L1	Microglia
ATL2	Microglia
ATOX1	Microglia
ATP6V1B2	Microglia
ATP6V1G2-DDX39B	Microglia
ATP8B2	Microglia
ATXN7L3B	Microglia
C5orf24	Microglia
BRK1	Microglia
BTBD3	Microglia
BZW1	Microglia
C1D	Microglia
C1GALT1C1	Microglia
CAMTA1	Microglia
CANX	Microglia
CBX4	Microglia
CCT3	Microglia
CD81	Microglia
CDC42EP3	Microglia
CDK17	Microglia
CDS2	Microglia
CFAP20	Microglia
CHP1	Microglia
CHST12	Microglia
CLPB	Microglia
CLPTM1	Microglia
CLPTM1L	Microglia
CMPK1	Microglia
CNIH4	Microglia
COMMD9	Microglia
COPB2	Microglia
COQ10A	Microglia
COX18	Microglia
CPSF2	Microglia
CST3	Microglia
CTNNB1	Microglia
CUTA	Microglia
DDA1	Microglia
DDX1	Microglia
DECR2	Microglia
DGCR2	Microglia
DHX38	Microglia
DLAT	Microglia
DLD	Microglia
DNAJA2	Microglia
DNAJC10	Microglia
DNAJC30	Microglia
DNM1L	Microglia
DPM2	Microglia
DYNC1LI2	Microglia
DZIP3	Microglia
EEF1AKMT1	Microglia
EEF1G	Microglia
EIF3L	Microglia
EPN2	Microglia
ERH	Microglia
FAM104B	Microglia
FAM126B	Microglia
FAM131A	Microglia
FAM136A	Microglia
FAM162A	Microglia
FAM98C	Microglia
FASTK	Microglia
FBXL2	Microglia
FBXO25	Microglia
FEM1B	Microglia
FKBP5	Microglia
FOCAD	Microglia
FRY	Microglia
GCC2	Microglia
GFM1	Microglia
GLRX3	Microglia
GMPS	Microglia
GOLGB1	Microglia
GPHN	Microglia
GRAMD1B	Microglia
GSK3A	Microglia
GTF2IRD1	Microglia
HGSNAT	Microglia
HNRNPDL	Microglia
HNRNPK	Microglia
HNRNPUL2-BSCL2	Microglia
HNRNPUL2	Microglia
HP1BP3	Microglia
HYOU1	Microglia
IFT57	Microglia
IMPACT	Microglia
INPP1	Microglia
INPP4A	Microglia
ITFG2	Microglia
ITM2B	Microglia
JAGN1	Microglia
JOSD1	Microglia
KCNMA1	Microglia
KDELR1	Microglia
KLHL23	Microglia
KLHL9	Microglia
KPNB1	Microglia
LMBRD2	Microglia
LONP1	Microglia
LRRC45	Microglia
MAPK1	Microglia
MATR3	Microglia
MCFD2	Microglia
MCTP1	Microglia
MED4	Microglia
MGAT2	Microglia
MICU3	Microglia
MIGA2	Microglia
MPND	Microglia
MRPL36	Microglia
MRPS25	Microglia
MRPS33	Microglia
MTPN	Microglia
MYPOP	Microglia
NARS1	Microglia
NBDY	Microglia
NCL	Microglia
NDUFA12	Microglia
NDUFS3	Microglia
NDUFV3	Microglia
NECAP1	Microglia
NFU1	Microglia
NOLC1	Microglia
NOP56	Microglia
NPTN	Microglia
NSF	Microglia
NSUN5	Microglia
NUCB2	Microglia
NUS1	Microglia
OLA1	Microglia
OSGEP	Microglia
PAK1IP1	Microglia
PBX1	Microglia
PCMT1	Microglia
PCNX4	Microglia
PDE4DIP	Microglia
PEA15	Microglia
PER1	Microglia
PFDN1	Microglia
PHB2	Microglia
PINK1	Microglia
PMPCA	Microglia
POLR2E	Microglia
POMP	Microglia
PPM1A	Microglia
PPM1F	Microglia
PPME1	Microglia
PPP1R13B	Microglia
PPP1R37	Microglia
PPP1R9A	Microglia
PPP2R1A	Microglia
PRICKLE1	Microglia
PRKG1	Microglia
PSAP	Microglia
PSMA1	Microglia
PSMD4	Microglia
PTK2B	Microglia
PTMS	Microglia
PURA	Microglia
PURB	Microglia
PURG	Microglia
R3HDM1	Microglia
RAB11FIP3	Microglia
RABGGTB	Microglia
RANBP1	Microglia
RASGRF2	Microglia
RBBP7	Microglia
RBX1	Microglia
RFX1	Microglia
RIPOR2	Microglia
RPL18A	Microglia
RPL22	Microglia
RPL6	Microglia
RPS24	Microglia
RPS4X	Microglia
SAP18	Microglia
SCN1B	Microglia
SDHAF1	Microglia
SDHB	Microglia
SEM1	Microglia
SERBP1	Microglia
SF3B2	Microglia
SFXN5	Microglia
SLC35F6	Microglia
SMC3	Microglia
SNRNP70	Microglia
SPNS1	Microglia
SQSTM1	Microglia
SRP9	Microglia
SRPK1	Microglia
SSBP4	Microglia
SSR4	Microglia
SSX2IP	Microglia
STIP1	Microglia
STUB1	Microglia
SUGT1	Microglia
SURF1	Microglia
TCF25	Microglia
TCP1	Microglia
TEF	Microglia
TESK1	Microglia
TIAM1	Microglia
TKT	Microglia
TM9SF4	Microglia
TMED2	Microglia
TMEM14C	Microglia
TMEM256	Microglia
TMEM256-PLSCR3	Microglia
TMEM59	Microglia
TMEM60	Microglia
TMSB4Y	Microglia
TOMM40L	Microglia
TPRG1L	Microglia
TPRKB	Microglia
TRIM37	Microglia
TSNAX-DISC1	Microglia
TXNDC15	Microglia
UBE2M	Microglia
UBTF	Microglia
UFC1	Microglia
UFSP2	Microglia
USP10	Microglia
USP11	Microglia
USP14	Microglia
USP30	Microglia
UXS1	Microglia
VCL	Microglia
VEGFB	Microglia
VPS35	Microglia
VPS37B	Microglia
WDR13	Microglia
WDR74	Microglia
WDR75	Microglia
YBX1	Microglia
YWHAG	Microglia
YWHAH	Microglia
ZCCHC14	Microglia
ZDHHC21	Microglia
ZDHHC8	Microglia
ZFAND1	Microglia
ZRANB2	Microglia
ACP1	MSN_Drd1+_1
ACTB	MSN_Drd1+_1
ALDOA	MSN_Drd1+_1
ANKRD33B	MSN_Drd1+_1
ANO3	MSN_Drd1+_1
ARF5	MSN_Drd1+_1
ATP1B1	MSN_Drd1+_1
ATP5MF	MSN_Drd1+_1
ATP6AP2	MSN_Drd1+_1
ATP6V0C	MSN_Drd1+_1
ATP6V1E1	MSN_Drd1+_1
C1QTNF4	MSN_Drd1+_1
CALM1	MSN_Drd1+_1
CARTPT	MSN_Drd1+_1
CELF3	MSN_Drd1+_1
CLK1	MSN_Drd1+_1
CNTN4	MSN_Drd1+_1
CNTN5	MSN_Drd1+_1
COX5A	MSN_Drd1+_1
COX7C	MSN_Drd1+_1
CSPG5	MSN_Drd1+_1
CTNNA3	MSN_Drd1+_1
DACH1	MSN_Drd1+_1
EBF1	MSN_Drd1+_1
EIF1	MSN_Drd1+_1
NALF1	MSN_Drd1+_1
FILIP1L	MSN_Drd1+_1
FRMD4B	MSN_Drd1+_1
FTH1	MSN_Drd1+_1
GAPDH	MSN_Drd1+_1
GRM1	MSN_Drd1+_1
GUCY1A1	MSN_Drd1+_1
HSP90AB1	MSN_Drd1+_1
HSPA8	MSN_Drd1+_1
HSPE1	MSN_Drd1+_1
IL1RAPL2	MSN_Drd1+_1
ITGAV	MSN_Drd1+_1
ITGBL1	MSN_Drd1+_1
ITM2B	MSN_Drd1+_1
ITM2C	MSN_Drd1+_1
KCNH7	MSN_Drd1+_1
KCNK1	MSN_Drd1+_1
KCTD16	MSN_Drd1+_1
KIFAP3	MSN_Drd1+_1
LAMP1	MSN_Drd1+_1
LDHB	MSN_Drd1+_1
LRRC4	MSN_Drd1+_1
LRTM1	MSN_Drd1+_1
LYSMD4	MSN_Drd1+_1
LZTS3	MSN_Drd1+_1
MAPK4	MSN_Drd1+_1
MSRA	MSN_Drd1+_1
NDUFA6	MSN_Drd1+_1
NRGN	MSN_Drd1+_1
NRP1	MSN_Drd1+_1
OAZ1	MSN_Drd1+_1
OPRM1	MSN_Drd1+_1
P2RY12	MSN_Drd1+_1
PCSK1N	MSN_Drd1+_1
PDE1A	MSN_Drd1+_1
PDE4D	MSN_Drd1+_1
PDZD2	MSN_Drd1+_1
PGRMC1	MSN_Drd1+_1
PISD	MSN_Drd1+_1
PLCL1	MSN_Drd1+_1
PNMA8B	MSN_Drd1+_1
PSMA7	MSN_Drd1+_1
PTCHD4	MSN_Drd1+_1
RAB14	MSN_Drd1+_1
RELN	MSN_Drd1+_1
ROBO2	MSN_Drd1+_1
RPS27	MSN_Drd1+_1
SCG2	MSN_Drd1+_1
SDK1	MSN_Drd1+_1
SEC62	MSN_Drd1+_1
SLC25A4	MSN_Drd1+_1
SLC32A1	MSN_Drd1+_1
SLC8A1	MSN_Drd1+_1
SLIT2	MSN_Drd1+_1
SNTG2	MSN_Drd1+_1
STMN3	MSN_Drd1+_1
SUB1	MSN_Drd1+_1
SYNE1	MSN_Drd1+_1
TAC1	MSN_Drd1+_1
TCF4	MSN_Drd1+_1
TMEM30A	MSN_Drd1+_1
TUBB2A	MSN_Drd1+_1
UBB	MSN_Drd1+_1
UCHL1	MSN_Drd1+_1
ZNF804A	MSN_Drd1+_1
AATK	MSN_Drd1+_2
ACSL3	MSN_Drd1+_2
ACTB	MSN_Drd1+_2
ADRA1A	MSN_Drd1+_2
ALDOA	MSN_Drd1+_2
ARF5	MSN_Drd1+_2
ARL6IP1	MSN_Drd1+_2
ARPC1A	MSN_Drd1+_2
ARPC5L	MSN_Drd1+_2
ASPHD2	MSN_Drd1+_2
ATP1B1	MSN_Drd1+_2
ATP2C1	MSN_Drd1+_2
ATP5F1A	MSN_Drd1+_2
ATP6V0C	MSN_Drd1+_2
ATP6V1A	MSN_Drd1+_2
ATP6V1E1	MSN_Drd1+_2
ATXN2L	MSN_Drd1+_2
BCAP31	MSN_Drd1+_2
BRD3	MSN_Drd1+_2
BRD9	MSN_Drd1+_2
BRI3	MSN_Drd1+_2
CALM1	MSN_Drd1+_2
CAMK1D	MSN_Drd1+_2
CANX	MSN_Drd1+_2
CARTPT	MSN_Drd1+_2
CCT3	MSN_Drd1+_2
CELF3	MSN_Drd1+_2
CHD6	MSN_Drd1+_2
CKB	MSN_Drd1+_2
CLK1	MSN_Drd1+_2
CLTC	MSN_Drd1+_2
COX5A	MSN_Drd1+_2
COX7A2L	MSN_Drd1+_2
COX7C	MSN_Drd1+_2
CRIP2	MSN_Drd1+_2
CRYM	MSN_Drd1+_2
CSPG5	MSN_Drd1+_2
CTNNA3	MSN_Drd1+_2
DBP	MSN_Drd1+_2
DNAJB11	MSN_Drd1+_2
DTX3	MSN_Drd1+_2
DYNLL1	MSN_Drd1+_2
DZIP1	MSN_Drd1+_2
EDIL3	MSN_Drd1+_2
EIF1	MSN_Drd1+_2
EIF3F	MSN_Drd1+_2
EMC7	MSN_Drd1+_2
ENC1	MSN_Drd1+_2
ESD	MSN_Drd1+_2
FILIP1L	MSN_Drd1+_2
FTH1	MSN_Drd1+_2
GABARAP	MSN_Drd1+_2
GABARAPL1	MSN_Drd1+_2
GAD1	MSN_Drd1+_2
GAPDH	MSN_Drd1+_2
GNB5	MSN_Drd1+_2
GPATCH2	MSN_Drd1+_2
GPC5	MSN_Drd1+_2
GPI	MSN_Drd1+_2
GPR22	MSN_Drd1+_2
GUK1	MSN_Drd1+_2
HSP90AA1	MSN_Drd1+_2
HSP90AB1	MSN_Drd1+_2
HSPA5	MSN_Drd1+_2
HSPA8	MSN_Drd1+_2
HSPE1	MSN_Drd1+_2
HSPH1	MSN_Drd1+_2
INPP4B	MSN_Drd1+_2
ITM2B	MSN_Drd1+_2
KCNA1	MSN_Drd1+_2
KIF1A	MSN_Drd1+_2
KIF1B	MSN_Drd1+_2
LENG8	MSN_Drd1+_2
LGMN	MSN_Drd1+_2
LMO4	MSN_Drd1+_2
LRRC10B	MSN_Drd1+_2
LRRC4	MSN_Drd1+_2
LRTM1	MSN_Drd1+_2
MAP1A	MSN_Drd1+_2
MAP3K3	MSN_Drd1+_2
MARCKS	MSN_Drd1+_2
MBP	MSN_Drd1+_2
MDH2	MSN_Drd1+_2
METTL23	MSN_Drd1+_2
MT1G	MSN_Drd1+_2
NAT8L	MSN_Drd1+_2
NDUFA6	MSN_Drd1+_2
NDUFA9	MSN_Drd1+_2
NDUFS2	MSN_Drd1+_2
NEDD4	MSN_Drd1+_2
NME7	MSN_Drd1+_2
NOP10	MSN_Drd1+_2
NPAS2	MSN_Drd1+_2
NPC2	MSN_Drd1+_2
NPDC1	MSN_Drd1+_2
OAZ1	MSN_Drd1+_2
OSBPL10	MSN_Drd1+_2
OSBPL3	MSN_Drd1+_2
OXR1	MSN_Drd1+_2
PAXBP1	MSN_Drd1+_2
PCSK1N	MSN_Drd1+_2
PER3	MSN_Drd1+_2
PGM2L1	MSN_Drd1+_2
PISD	MSN_Drd1+_2
PNRC1	MSN_Drd1+_2
PODXL2	MSN_Drd1+_2
POLR2E	MSN_Drd1+_2
PPP1R1B	MSN_Drd1+_2
PRELID3A	MSN_Drd1+_2
PRKACB	MSN_Drd1+_2
PSMA5	MSN_Drd1+_2
PSMA7	MSN_Drd1+_2
PSMB3	MSN_Drd1+_2
PSMD9	MSN_Drd1+_2
RAB14	MSN_Drd1+_2
RAB3A	MSN_Drd1+_2
RANGAP1	MSN_Drd1+_2
RBM20	MSN_Drd1+_2
REEP5	MSN_Drd1+_2
RNF227	MSN_Drd1+_2
RPL10A	MSN_Drd1+_2
SCD	MSN_Drd1+_2
SEC62	MSN_Drd1+_2
SELENOM	MSN_Drd1+_2
SEMA3E	MSN_Drd1+_2
SIRPG	MSN_Drd1+_2
SIRPB1	MSN_Drd1+_2
SIRPA	MSN_Drd1+_2
SIRT7	MSN_Drd1+_2
SLC25A27	MSN_Drd1+_2
SLC25A5	MSN_Drd1+_2
SNRPE	MSN_Drd1+_2
SPCS2	MSN_Drd1+_2
SRSF2	MSN_Drd1+_2
SSR3	MSN_Drd1+_2
ST8SIA3	MSN_Drd1+_2
STMN1	MSN_Drd1+_2
STMN2	MSN_Drd1+_2
STX16	MSN_Drd1+_2
STX16-NPEPL1	MSN_Drd1+_2
SUB1	MSN_Drd1+_2
SYT11	MSN_Drd1+_2
TAC1	MSN_Drd1+_2
TAF1D	MSN_Drd1+_2
TECR	MSN_Drd1+_2
TGOLN2	MSN_Drd1+_2
TIMM13	MSN_Drd1+_2
TMA7	MSN_Drd1+_2
TMEM151A	MSN_Drd1+_2
TMEM178A	MSN_Drd1+_2
TMEM243	MSN_Drd1+_2
TMX2	MSN_Drd1+_2
TOP1	MSN_Drd1+_2
TPI1	MSN_Drd1+_2
UBB	MSN_Drd1+_2
UBE4B	MSN_Drd1+_2
UCHL3	MSN_Drd1+_2
UNC50	MSN_Drd1+_2
WWP1	MSN_Drd1+_2
YWHAH	MSN_Drd1+_2
C4orf3	MSN_Drd1+_3
AP2S1	MSN_Drd1+_3
ARF5	MSN_Drd1+_3
ARPC1A	MSN_Drd1+_3
ATP1A1	MSN_Drd1+_3
ATP5F1B	MSN_Drd1+_3
ATP6V1E1	MSN_Drd1+_3
ATXN7L3B	MSN_Drd1+_3
BEX1	MSN_Drd1+_3
BEX2	MSN_Drd1+_3
BRI3	MSN_Drd1+_3
C1QTNF4	MSN_Drd1+_3
CALM2	MSN_Drd1+_3
CCT7	MSN_Drd1+_3
CCT8	MSN_Drd1+_3
CDC37	MSN_Drd1+_3
CHGA	MSN_Drd1+_3
COX7C	MSN_Drd1+_3
CUTA	MSN_Drd1+_3
CYC1	MSN_Drd1+_3
C19orf53	MSN_Drd1+_3
DDX3Y	MSN_Drd1+_3
EEF1A1	MSN_Drd1+_3
EIF1B	MSN_Drd1+_3
EIF3C	MSN_Drd1+_3
EIF3CL	MSN_Drd1+_3
EMC6	MSN_Drd1+_3
ENO1	MSN_Drd1+_3
ESD	MSN_Drd1+_3
EXTL2	MSN_Drd1+_3
FADS1	MSN_Drd1+_3
FBXO11	MSN_Drd1+_3
GABRB3	MSN_Drd1+_3
GDE1	MSN_Drd1+_3
GNA11	MSN_Drd1+_3
GOT1	MSN_Drd1+_3
HPCA	MSN_Drd1+_3
HSPE1	MSN_Drd1+_3
KCNIP1	MSN_Drd1+_3
KCNJ4	MSN_Drd1+_3
KPNA6	MSN_Drd1+_3
LDHB	MSN_Drd1+_3
LGR4	MSN_Drd1+_3
LIN7B	MSN_Drd1+_3
LRRTM3	MSN_Drd1+_3
MDH1	MSN_Drd1+_3
MDH2	MSN_Drd1+_3
MRPL20	MSN_Drd1+_3
NACA	MSN_Drd1+_3
NDUFA6	MSN_Drd1+_3
NDUFAB1	MSN_Drd1+_3
NDUFB2	MSN_Drd1+_3
NDUFB4	MSN_Drd1+_3
NDUFS2	MSN_Drd1+_3
NOP10	MSN_Drd1+_3
NUDC	MSN_Drd1+_3
OAZ1	MSN_Drd1+_3
PKM	MSN_Drd1+_3
PLEKHJ1	MSN_Drd1+_3
PNMA8B	MSN_Drd1+_3
PPP1R1B	MSN_Drd1+_3
PRDX5	MSN_Drd1+_3
PRR7	MSN_Drd1+_3
PSMA4	MSN_Drd1+_3
PSMA7	MSN_Drd1+_3
PSMB3	MSN_Drd1+_3
PSMC2	MSN_Drd1+_3
RNF7	MSN_Drd1+_3
RPL22L1	MSN_Drd1+_3
RPS13	MSN_Drd1+_3
RPS20	MSN_Drd1+_3
SCN2B	MSN_Drd1+_3
SEC62	MSN_Drd1+_3
SELENOF	MSN_Drd1+_3
SFR1	MSN_Drd1+_3
SLC32A1	MSN_Drd1+_3
SNU13	MSN_Drd1+_3
STMN3	MSN_Drd1+_3
TALDO1	MSN_Drd1+_3
TCF25	MSN_Drd1+_3
TIMM8B	MSN_Drd1+_3
TMA7	MSN_Drd1+_3
TMEM158	MSN_Drd1+_3
TOMM20	MSN_Drd1+_3
UTY	MSN_Drd1+_3
VDAC2	MSN_Drd1+_3
VDAC3	MSN_Drd1+_3
YWHAB	MSN_Drd1+_3
YWHAH	MSN_Drd1+_3
ZMAT2	MSN_Drd1+_3
ACTB	MSN_Drd2+_1
ACTG1	MSN_Drd2+_1
ALDOA	MSN_Drd2+_1
ARGLU1	MSN_Drd2+_1
ARL6IP1	MSN_Drd2+_1
ATG16L2	MSN_Drd2+_1
ATP1B1	MSN_Drd2+_1
ATP5F1D	MSN_Drd2+_1
ATP5MC3	MSN_Drd2+_1
ATP6AP2	MSN_Drd2+_1
ATP6V0C	MSN_Drd2+_1
ATP6V1D	MSN_Drd2+_1
BEX1	MSN_Drd2+_1
BEX2	MSN_Drd2+_1
BRINP3	MSN_Drd2+_1
CALM1	MSN_Drd2+_1
CAPZA2	MSN_Drd2+_1
CARTPT	MSN_Drd2+_1
CELF3	MSN_Drd2+_1
CHCHD10	MSN_Drd2+_1
CHCHD2	MSN_Drd2+_1
CHGA	MSN_Drd2+_1
CHSY3	MSN_Drd2+_1
CKB	MSN_Drd2+_1
CNTN4	MSN_Drd2+_1
COX5A	MSN_Drd2+_1
COX6C	MSN_Drd2+_1
COX7C	MSN_Drd2+_1
CTNNA3	MSN_Drd2+_1
DNAJB6	MSN_Drd2+_1
DPM1	MSN_Drd2+_1
EIF1	MSN_Drd2+_1
EIF3K	MSN_Drd2+_1
KIAA1217	MSN_Drd2+_1
NALF1	MSN_Drd2+_1
FAU	MSN_Drd2+_1
FILIP1L	MSN_Drd2+_1
FTH1	MSN_Drd2+_1
GAD2	MSN_Drd2+_1
GAPDH	MSN_Drd2+_1
GAREM1	MSN_Drd2+_1
GDE1	MSN_Drd2+_1
GNAS	MSN_Drd2+_1
GOT1	MSN_Drd2+_1
GPR88	MSN_Drd2+_1
GRM1	MSN_Drd2+_1
GUCY1A1	MSN_Drd2+_1
HSP90AA1	MSN_Drd2+_1
HSP90AB1	MSN_Drd2+_1
HSPA8	MSN_Drd2+_1
IGSF8	MSN_Drd2+_1
ITM2B	MSN_Drd2+_1
ITM2C	MSN_Drd2+_1
JUND	MSN_Drd2+_1
KCNA1	MSN_Drd2+_1
KCNK1	MSN_Drd2+_1
KIF1A	MSN_Drd2+_1
KIFAP3	MSN_Drd2+_1
LINGO2	MSN_Drd2+_1
LRRC4	MSN_Drd2+_1
LRTM1	MSN_Drd2+_1
LYSMD4	MSN_Drd2+_1
LZTS3	MSN_Drd2+_1
MDH1	MSN_Drd2+_1
MRFAP1L1	MSN_Drd2+_1
MRFAP1	MSN_Drd2+_1
NDUFA6	MSN_Drd2+_1
NPAS3	MSN_Drd2+_1
NSG1	MSN_Drd2+_1
OPRM1	MSN_Drd2+_1
PAFAH1B1	MSN_Drd2+_1
PBX3	MSN_Drd2+_1
PCSK1N	MSN_Drd2+_1
PEG3	MSN_Drd2+_1
PENK	MSN_Drd2+_1
PGAM4	MSN_Drd2+_1
PGAM1	MSN_Drd2+_1
PGRMC1	MSN_Drd2+_1
PISD	MSN_Drd2+_1
PSMA7	MSN_Drd2+_1
PTCHD4	MSN_Drd2+_1
RAB14	MSN_Drd2+_1
RELN	MSN_Drd2+_1
RNF150	MSN_Drd2+_1
ROBO2	MSN_Drd2+_1
RPL13	MSN_Drd2+_1
RPL37	MSN_Drd2+_1
RPS21	MSN_Drd2+_1
RPS27	MSN_Drd2+_1
RPS29	MSN_Drd2+_1
RPS8	MSN_Drd2+_1
RRAGD	MSN_Drd2+_1
SARAF	MSN_Drd2+_1
SCG2	MSN_Drd2+_1
SEC62	MSN_Drd2+_1
SELENOM	MSN_Drd2+_1
SERBP1	MSN_Drd2+_1
SERINC1	MSN_Drd2+_1
SHISA9	MSN_Drd2+_1
SLC25A4	MSN_Drd2+_1
SLC25A5	MSN_Drd2+_1
SLC32A1	MSN_Drd2+_1
SLC8A1	MSN_Drd2+_1
SLIT2	MSN_Drd2+_1
STMN3	MSN_Drd2+_1
STXBP6	MSN_Drd2+_1
SUGT1	MSN_Drd2+_1
TAC1	MSN_Drd2+_1
TESC	MSN_Drd2+_1
TMEM30A	MSN_Drd2+_1
TPT1	MSN_Drd2+_1
TSPYL4	MSN_Drd2+_1
TUBB2A	MSN_Drd2+_1
TUBB	MSN_Drd2+_1
UBB	MSN_Drd2+_1
UBC	MSN_Drd2+_1
UNC50	MSN_Drd2+_1
YWHAH	MSN_Drd2+_1
ACTB	MSN_Drd2+_2
ACTG1	MSN_Drd2+_2
ALDOA	MSN_Drd2+_2
ATP1B1	MSN_Drd2+_2
ATP5MC3	MSN_Drd2+_2
ATP5PD	MSN_Drd2+_2
ATP6V0C	MSN_Drd2+_2
BAG1	MSN_Drd2+_2
CALM1	MSN_Drd2+_2
CHCHD10	MSN_Drd2+_2
CHST1	MSN_Drd2+_2
CKB	MSN_Drd2+_2
CNTFR	MSN_Drd2+_2
COX5A	MSN_Drd2+_2
COX6C	MSN_Drd2+_2
COX7C	MSN_Drd2+_2
EIF1	MSN_Drd2+_2
EIF3F	MSN_Drd2+_2
EMC7	MSN_Drd2+_2
FKBP3	MSN_Drd2+_2
FTH1	MSN_Drd2+_2
GAPDH	MSN_Drd2+_2
GPC5	MSN_Drd2+_2
GPR22	MSN_Drd2+_2
HSP90AA1	MSN_Drd2+_2
HSP90AB1	MSN_Drd2+_2
HSPA8	MSN_Drd2+_2
HSPE1	MSN_Drd2+_2
KIFAP3	MSN_Drd2+_2
LUZP2	MSN_Drd2+_2
MIF	MSN_Drd2+_2
MON2	MSN_Drd2+_2
MRPL30	MSN_Drd2+_2
MRPL57	MSN_Drd2+_2
NDUFA4	MSN_Drd2+_2
NDUFA6	MSN_Drd2+_2
NDUFS7	MSN_Drd2+_2
PCSK1N	MSN_Drd2+_2
PDIA3	MSN_Drd2+_2
PGAM4	MSN_Drd2+_2
PGAM1	MSN_Drd2+_2
PGRMC1	MSN_Drd2+_2
PISD	MSN_Drd2+_2
PLPPR4	MSN_Drd2+_2
POU6F1	MSN_Drd2+_2
PSMA7	MSN_Drd2+_2
RAB14	MSN_Drd2+_2
RAB3A	MSN_Drd2+_2
SERINC1	MSN_Drd2+_2
SH3BGRL3	MSN_Drd2+_2
SLC16A11	MSN_Drd2+_2
SLC25A4	MSN_Drd2+_2
SYT11	MSN_Drd2+_2
TAC1	MSN_Drd2+_2
TGOLN2	MSN_Drd2+_2
TIMM8B	MSN_Drd2+_2
TTLL7	MSN_Drd2+_2
TTYH1	MSN_Drd2+_2
TUBA1A	MSN_Drd2+_2
TUBB	MSN_Drd2+_2
TUSC3	MSN_Drd2+_2
UBB	MSN_Drd2+_2
USP28	MSN_Drd2+_2
NCBP2AS2	MSN_Drd3+_1
C4orf3	MSN_Drd3+_1
SMIM30	MSN_Drd3+_1
ACHE	MSN_Drd3+_1
ACTB	MSN_Drd3+_1
ADGRB2	MSN_Drd3+_1
APLP1	MSN_Drd3+_1
APLP2	MSN_Drd3+_1
APP	MSN_Drd3+_1
ARF1	MSN_Drd3+_1
ARF5	MSN_Drd3+_1
ARMCX2	MSN_Drd3+_1
ARPC1A	MSN_Drd3+_1
ARPC2	MSN_Drd3+_1
ARPP19	MSN_Drd3+_1
ARPP21	MSN_Drd3+_1
ASPHD2	MSN_Drd3+_1
ATL1	MSN_Drd3+_1
ATP1A1	MSN_Drd3+_1
ATP1A2	MSN_Drd3+_1
ATP1A3	MSN_Drd3+_1
ATP1B1	MSN_Drd3+_1
ATP2A2	MSN_Drd3+_1
ATP2B1	MSN_Drd3+_1
ATP5F1A	MSN_Drd3+_1
ATP5F1B	MSN_Drd3+_1
ATP5MF	MSN_Drd3+_1
ATP5MGL	MSN_Drd3+_1
ATP5MG	MSN_Drd3+_1
ATP5MJ	MSN_Drd3+_1
ATP6V1D	MSN_Drd3+_1
ATP6V1E1	MSN_Drd3+_1
ATP6V1F	MSN_Drd3+_1
B4GALNT1	MSN_Drd3+_1
BEX1	MSN_Drd3+_1
BEX2	MSN_Drd3+_1
BOLA1	MSN_Drd3+_1
BRI3	MSN_Drd3+_1
BRI3BP	MSN_Drd3+_1
BRK1	MSN_Drd3+_1
C1QTNF4	MSN_Drd3+_1
CADM4	MSN_Drd3+_1
CALM2	MSN_Drd3+_1
CAMK1D	MSN_Drd3+_1
CAMK2B	MSN_Drd3+_1
CAMKV	MSN_Drd3+_1
CARTPT	MSN_Drd3+_1
CCDC85B	MSN_Drd3+_1
CCT7	MSN_Drd3+_1
CD320	MSN_Drd3+_1
CD47	MSN_Drd3+_1
CDC37	MSN_Drd3+_1
CIRBP	MSN_Drd3+_1
CKB	MSN_Drd3+_1
CLSTN1	MSN_Drd3+_1
CLTA	MSN_Drd3+_1
CNIH2	MSN_Drd3+_1
COX14	MSN_Drd3+_1
COX7C	MSN_Drd3+_1
CPLX1	MSN_Drd3+_1
CPNE5	MSN_Drd3+_1
CREB3	MSN_Drd3+_1
CSPG5	MSN_Drd3+_1
CSTB	MSN_Drd3+_1
CX3CL1	MSN_Drd3+_1
CYC1	MSN_Drd3+_1
CYCS	MSN_Drd3+_1
CYLD	MSN_Drd3+_1
CYP46A1	MSN_Drd3+_1
DENR	MSN_Drd3+_1
DLG2	MSN_Drd3+_1
DYNLL1	MSN_Drd3+_1
DYNLL2	MSN_Drd3+_1
EIF1	MSN_Drd3+_1
EIF3C	MSN_Drd3+_1
EIF3CL	MSN_Drd3+_1
EIF3K	MSN_Drd3+_1
EIF4G2	MSN_Drd3+_1
EIF5AL1	MSN_Drd3+_1
EIF5A	MSN_Drd3+_1
ELK4	MSN_Drd3+_1
ELMOD1	MSN_Drd3+_1
EMC4	MSN_Drd3+_1
ENO1	MSN_Drd3+_1
ENPP5	MSN_Drd3+_1
EPHA4	MSN_Drd3+_1
FAM174A	MSN_Drd3+_1
FAM81A	MSN_Drd3+_1
FBXO32	MSN_Drd3+_1
FKBP3	MSN_Drd3+_1
FKBP8	MSN_Drd3+_1
FMC1	MSN_Drd3+_1
FRRS1L	MSN_Drd3+_1
FTL	MSN_Drd3+_1
GABARAPL1	MSN_Drd3+_1
GABARAPL2	MSN_Drd3+_1
GABRD	MSN_Drd3+_1
GDI1	MSN_Drd3+_1
PNMA8C	MSN_Drd3+_1
GNAS	MSN_Drd3+_1
GNB2	MSN_Drd3+_1
GOT1	MSN_Drd3+_1
GOT2	MSN_Drd3+_1
HABP4	MSN_Drd3+_1
HINT1	MSN_Drd3+_1
HSBP1	MSN_Drd3+_1
ICAM5	MSN_Drd3+_1
IGSF8	MSN_Drd3+_1
IMP3	MSN_Drd3+_1
INPP4A	MSN_Drd3+_1
INPP5F	MSN_Drd3+_1
ITM2B	MSN_Drd3+_1
ITM2C	MSN_Drd3+_1
JUNB	MSN_Drd3+_1
KCNA2	MSN_Drd3+_1
KCNJ4	MSN_Drd3+_1
KCNS2	MSN_Drd3+_1
KCTD17	MSN_Drd3+_1
KIDINS220	MSN_Drd3+_1
KIF5C	MSN_Drd3+_1
LGI2	MSN_Drd3+_1
LRPAP1	MSN_Drd3+_1
LY6H	MSN_Drd3+_1
LYPLA2	MSN_Drd3+_1
MAGED1	MSN_Drd3+_1
MAP1B	MSN_Drd3+_1
MAP1LC3A	MSN_Drd3+_1
MAST3	MSN_Drd3+_1
MDH2	MSN_Drd3+_1
MEN1	MSN_Drd3+_1
MLF2	MSN_Drd3+_1
MOGS	MSN_Drd3+_1
MRFAP1L1	MSN_Drd3+_1
MRFAP1	MSN_Drd3+_1
MRPL41	MSN_Drd3+_1
MRPS14	MSN_Drd3+_1
MSMO1	MSN_Drd3+_1
MTCH1	MSN_Drd3+_1
NACA	MSN_Drd3+_1
NAT8L	MSN_Drd3+_1
NCAM2	MSN_Drd3+_1
NCAN	MSN_Drd3+_1
NCDN	MSN_Drd3+_1
NCL	MSN_Drd3+_1
NDRG4	MSN_Drd3+_1
NDUFA6	MSN_Drd3+_1
NDUFAF8	MSN_Drd3+_1
NDUFB9	MSN_Drd3+_1
NDUFV2	MSN_Drd3+_1
NEU1	MSN_Drd3+_1
NGEF	MSN_Drd3+_1
NOP10	MSN_Drd3+_1
NPY	MSN_Drd3+_1
NRGN	MSN_Drd3+_1
NSG1	MSN_Drd3+_1
OAZ1	MSN_Drd3+_1
ORMDL3	MSN_Drd3+_1
OTUB1	MSN_Drd3+_1
PDCD7	MSN_Drd3+_1
PDE1B	MSN_Drd3+_1
PDXK	MSN_Drd3+_1
PENK	MSN_Drd3+_1
PFDN2	MSN_Drd3+_1
PJA2	MSN_Drd3+_1
PKM	MSN_Drd3+_1
PLPPR4	MSN_Drd3+_1
POP5	MSN_Drd3+_1
PPP1R1A	MSN_Drd3+_1
PPP1R1B	MSN_Drd3+_1
PPP3CA	MSN_Drd3+_1
PRKCB	MSN_Drd3+_1
PSAP	MSN_Drd3+_1
PSD	MSN_Drd3+_1
PSMA2	MSN_Drd3+_1
PSMA5	MSN_Drd3+_1
PSMB6	MSN_Drd3+_1
PTGDS	MSN_Drd3+_1
PTK2B	MSN_Drd3+_1
PTPRN	MSN_Drd3+_1
TGIF2-RAB5IF	MSN_Drd3+_1
RAB5IF	MSN_Drd3+_1
RAB6B	MSN_Drd3+_1
RACK1	MSN_Drd3+_1
RANGAP1	MSN_Drd3+_1
RASGRP2	MSN_Drd3+_1
RESF1	MSN_Drd3+_1
RETREG2	MSN_Drd3+_1
REX1BD	MSN_Drd3+_1
RNF7	MSN_Drd3+_1
RPL27A	MSN_Drd3+_1
RPL30	MSN_Drd3+_1
RPL36A	MSN_Drd3+_1
RPL37A	MSN_Drd3+_1
RPRML	MSN_Drd3+_1
RPS13	MSN_Drd3+_1
RPS2	MSN_Drd3+_1
RPS27	MSN_Drd3+_1
RPS28	MSN_Drd3+_1
RRP1	MSN_Drd3+_1
RTN1	MSN_Drd3+_1
RTN4	MSN_Drd3+_1
SCG5	MSN_Drd3+_1
SELENOF	MSN_Drd3+_1
SELENOW	MSN_Drd3+_1
SERINC1	MSN_Drd3+_1
SH2D5	MSN_Drd3+_1
SH3GLB2	MSN_Drd3+_1
SLC22A17	MSN_Drd3+_1
SLC25A11	MSN_Drd3+_1
SLC25A3	MSN_Drd3+_1
SLC25A4	MSN_Drd3+_1
SLC32A1	MSN_Drd3+_1
SLC4A3	MSN_Drd3+_1
SNAP47	MSN_Drd3+_1
SNU13	MSN_Drd3+_1
SORL1	MSN_Drd3+_1
SPARCL1	MSN_Drd3+_1
SPOCK2	MSN_Drd3+_1
SRC	MSN_Drd3+_1
SRP9	MSN_Drd3+_1
SRPRA	MSN_Drd3+_1
STMN3	MSN_Drd3+_1
STXBP6	MSN_Drd3+_1
SV2A	MSN_Drd3+_1
TCEAL6	MSN_Drd3+_1
TCEAL5	MSN_Drd3+_1
TCEAL3	MSN_Drd3+_1
THRA	MSN_Drd3+_1
TM9SF3	MSN_Drd3+_1
TM9SF4	MSN_Drd3+_1
TMA7	MSN_Drd3+_1
TMBIM4	MSN_Drd3+_1
TMEM147	MSN_Drd3+_1
TOB1	MSN_Drd3+_1
TOMM20	MSN_Drd3+_1
TOMM70	MSN_Drd3+_1
TPI1	MSN_Drd3+_1
TPM1	MSN_Drd3+_1
TSNAX-DISC1	MSN_Drd3+_1
TSPAN3	MSN_Drd3+_1
TSPYL1	MSN_Drd3+_1
TTC3	MSN_Drd3+_1
UBB	MSN_Drd3+_1
UNC50	MSN_Drd3+_1
UQCRH	MSN_Drd3+_1
UQCRHL	MSN_Drd3+_1
VGF	MSN_Drd3+_1
VPS4A	MSN_Drd3+_1
VSTM2L	MSN_Drd3+_1
VSTM5	MSN_Drd3+_1
XBP1	MSN_Drd3+_1
YWHAB	MSN_Drd3+_1
YWHAH	MSN_Drd3+_1
ZNF428	MSN_Drd3+_1
AAMP	MSN_Grm8+_1
ABHD17A	MSN_Grm8+_1
ACVR1C	MSN_Grm8+_1
ADAMTSL1	MSN_Grm8+_1
ADGRB2	MSN_Grm8+_1
AHI1	MSN_Grm8+_1
AKAP5	MSN_Grm8+_1
ANO3	MSN_Grm8+_1
APOA1	MSN_Grm8+_1
ARF1	MSN_Grm8+_1
ARF5	MSN_Grm8+_1
ARHGDIA	MSN_Grm8+_1
ARPC1A	MSN_Grm8+_1
ARPC3	MSN_Grm8+_1
ARPC5L	MSN_Grm8+_1
ARPP19	MSN_Grm8+_1
ARPP21	MSN_Grm8+_1
SPCS3	MSN_Grm8+_1
ASPHD2	MSN_Grm8+_1
ATP1A1	MSN_Grm8+_1
ATP1A3	MSN_Grm8+_1
ATP2A2	MSN_Grm8+_1
ATP2B1	MSN_Grm8+_1
ATP2B2	MSN_Grm8+_1
ATP5F1A	MSN_Grm8+_1
ATP5F1B	MSN_Grm8+_1
ATP5MF	MSN_Grm8+_1
ATP5MGL	MSN_Grm8+_1
ATP5MG	MSN_Grm8+_1
ATP6V1D	MSN_Grm8+_1
ATP6V1E1	MSN_Grm8+_1
ATP9B	MSN_Grm8+_1
ATXN2L	MSN_Grm8+_1
BAG5	MSN_Grm8+_1
BRK1	MSN_Grm8+_1
BSG	MSN_Grm8+_1
C1GALT1C1	MSN_Grm8+_1
C1QTNF4	MSN_Grm8+_1
C2CD2L	MSN_Grm8+_1
CACNA1A	MSN_Grm8+_1
CACNB4	MSN_Grm8+_1
CADM2	MSN_Grm8+_1
CADM4	MSN_Grm8+_1
CALM1	MSN_Grm8+_1
CALM2	MSN_Grm8+_1
CALN1	MSN_Grm8+_1
CALY	MSN_Grm8+_1
CAMK1D	MSN_Grm8+_1
CAMK2N1	MSN_Grm8+_1
CAMKV	MSN_Grm8+_1
CD81	MSN_Grm8+_1
CDC37	MSN_Grm8+_1
CDC37L1	MSN_Grm8+_1
CDH13	MSN_Grm8+_1
CDIPT	MSN_Grm8+_1
CDK5R1	MSN_Grm8+_1
CEBPB	MSN_Grm8+_1
CELF2	MSN_Grm8+_1
CHRM3	MSN_Grm8+_1
COX14	MSN_Grm8+_1
COX7A2L	MSN_Grm8+_1
COX7C	MSN_Grm8+_1
CPLX1	MSN_Grm8+_1
CPLX2	MSN_Grm8+_1
CTXN1	MSN_Grm8+_1
CUEDC2	MSN_Grm8+_1
CYC1	MSN_Grm8+_1
CYCS	MSN_Grm8+_1
C19orf53	MSN_Grm8+_1
DLGAP1	MSN_Grm8+_1
DSCAM	MSN_Grm8+_1
EIF5AL1	MSN_Grm8+_1
EIF5A	MSN_Grm8+_1
ELMOD1	MSN_Grm8+_1
ENC1	MSN_Grm8+_1
ENDOG	MSN_Grm8+_1
ENO1	MSN_Grm8+_1
EPHA4	MSN_Grm8+_1
ESD	MSN_Grm8+_1
FAM76B	MSN_Grm8+_1
FBXL16	MSN_Grm8+_1
FHOD3	MSN_Grm8+_1
FKBP1C	MSN_Grm8+_1
FKBP1A	MSN_Grm8+_1
FKBP8	MSN_Grm8+_1
FOXP1	MSN_Grm8+_1
FTH1	MSN_Grm8+_1
FTL	MSN_Grm8+_1
G3BP2	MSN_Grm8+_1
GABARAPL1	MSN_Grm8+_1
GABRD	MSN_Grm8+_1
GAPDH	MSN_Grm8+_1
GDE1	MSN_Grm8+_1
GNL1	MSN_Grm8+_1
GOLGA5	MSN_Grm8+_1
GOT1	MSN_Grm8+_1
GRIA1	MSN_Grm8+_1
GUK1	MSN_Grm8+_1
HEBP1	MSN_Grm8+_1
HINT1	MSN_Grm8+_1
HNRNPA0	MSN_Grm8+_1
HSP90AB1	MSN_Grm8+_1
HSPA8	MSN_Grm8+_1
HSPE1	MSN_Grm8+_1
ICAM5	MSN_Grm8+_1
ITM2B	MSN_Grm8+_1
ITPKA	MSN_Grm8+_1
JCAD	MSN_Grm8+_1
JOSD1	MSN_Grm8+_1
KIF22	MSN_Grm8+_1
KIFAP3	MSN_Grm8+_1
LAMP1	MSN_Grm8+_1
LDHB	MSN_Grm8+_1
LETM2	MSN_Grm8+_1
LGMN	MSN_Grm8+_1
LGR4	MSN_Grm8+_1
LRTM1	MSN_Grm8+_1
LYSMD2	MSN_Grm8+_1
MAP1A	MSN_Grm8+_1
MBP	MSN_Grm8+_1
MCU	MSN_Grm8+_1
MDH1	MSN_Grm8+_1
MDH2	MSN_Grm8+_1
MRPL20	MSN_Grm8+_1
MRPL35	MSN_Grm8+_1
MT1G	MSN_Grm8+_1
MTUS2	MSN_Grm8+_1
NAP1L2	MSN_Grm8+_1
NCL	MSN_Grm8+_1
NDN	MSN_Grm8+_1
NDRG4	MSN_Grm8+_1
NDUFA4	MSN_Grm8+_1
NDUFA6	MSN_Grm8+_1
NDUFAB1	MSN_Grm8+_1
NDUFB3	MSN_Grm8+_1
NDUFS2	MSN_Grm8+_1
NDUFV1	MSN_Grm8+_1
NEDD4	MSN_Grm8+_1
NFE2L1	MSN_Grm8+_1
NFIA	MSN_Grm8+_1
NIPSNAP1	MSN_Grm8+_1
NLK	MSN_Grm8+_1
NOP10	MSN_Grm8+_1
NRGN	MSN_Grm8+_1
NRSN2	MSN_Grm8+_1
NUDC	MSN_Grm8+_1
OAZ1	MSN_Grm8+_1
OGFRL1	MSN_Grm8+_1
OLFM1	MSN_Grm8+_1
PCSK1N	MSN_Grm8+_1
PDAP1	MSN_Grm8+_1
PDCD6	MSN_Grm8+_1
PDE10A	MSN_Grm8+_1
PDE1A	MSN_Grm8+_1
PDE1B	MSN_Grm8+_1
PDIA3	MSN_Grm8+_1
PDIA6	MSN_Grm8+_1
PEX5L	MSN_Grm8+_1
PFDN6	MSN_Grm8+_1
PGRMC1	MSN_Grm8+_1
PHYHIP	MSN_Grm8+_1
PLK2	MSN_Grm8+_1
POLR2E	MSN_Grm8+_1
PPP1R15B	MSN_Grm8+_1
PPP1R2	MSN_Grm8+_1
PPP1R2B	MSN_Grm8+_1
PPP3R1	MSN_Grm8+_1
PRICKLE1	MSN_Grm8+_1
PRKCB	MSN_Grm8+_1
PRKG1	MSN_Grm8+_1
PSMA4	MSN_Grm8+_1
PSMA5	MSN_Grm8+_1
PSMA7	MSN_Grm8+_1
PSMC3	MSN_Grm8+_1
PTPRM	MSN_Grm8+_1
RANGAP1	MSN_Grm8+_1
REEP5	MSN_Grm8+_1
RELN	MSN_Grm8+_1
RERG	MSN_Grm8+_1
RNF169	MSN_Grm8+_1
RNF7	MSN_Grm8+_1
ROCK1	MSN_Grm8+_1
RPL10A	MSN_Grm8+_1
RPL22L1	MSN_Grm8+_1
RPL36A	MSN_Grm8+_1
RPS13	MSN_Grm8+_1
RPS15	MSN_Grm8+_1
SEC14L1	MSN_Grm8+_1
SLC25A11	MSN_Grm8+_1
SLC25A3	MSN_Grm8+_1
SPCS2	MSN_Grm8+_1
SPIN1	MSN_Grm8+_1
ST8SIA3	MSN_Grm8+_1
STARD10	MSN_Grm8+_1
STMN1	MSN_Grm8+_1
STMN4	MSN_Grm8+_1
STX1B	MSN_Grm8+_1
SYT11	MSN_Grm8+_1
TALDO1	MSN_Grm8+_1
TCEAL9	MSN_Grm8+_1
TCF25	MSN_Grm8+_1
TENM1	MSN_Grm8+_1
TGOLN2	MSN_Grm8+_1
TIMM13	MSN_Grm8+_1
TIMP2	MSN_Grm8+_1
TM2D3	MSN_Grm8+_1
TMA7	MSN_Grm8+_1
TMEM132A	MSN_Grm8+_1
TMEM147	MSN_Grm8+_1
TMEM30A	MSN_Grm8+_1
TOMM70	MSN_Grm8+_1
TPM1	MSN_Grm8+_1
TRIO	MSN_Grm8+_1
TSPYL1	MSN_Grm8+_1
TUBA1A	MSN_Grm8+_1
TUBB2A	MSN_Grm8+_1
UBA52	MSN_Grm8+_1
UNC50	MSN_Grm8+_1
UQCRC1	MSN_Grm8+_1
VDAC2	MSN_Grm8+_1
VDAC3	MSN_Grm8+_1
WBP4	MSN_Grm8+_1
YWHAB	MSN_Grm8+_1
YWHAH	MSN_Grm8+_1
YWHAQ	MSN_Grm8+_1
ZNF385B	MSN_Grm8+_1
ZMAT2	MSN_Grm8+_1
ADCY5	MSN_Grm8+_2
ALCAM	MSN_Grm8+_2
ATXN7L3	MSN_Grm8+_2
C1QTNF4	MSN_Grm8+_2
CACNA2D3	MSN_Grm8+_2
CALN1	MSN_Grm8+_2
CCNI	MSN_Grm8+_2
CD81	MSN_Grm8+_2
CLSTN1	MSN_Grm8+_2
DLGAP1	MSN_Grm8+_2
DRAM1	MSN_Grm8+_2
ERP29	MSN_Grm8+_2
FTH1	MSN_Grm8+_2
GABBR1	MSN_Grm8+_2
GJC3	MSN_Grm8+_2
GNAL	MSN_Grm8+_2
GRB2	MSN_Grm8+_2
GRIK4	MSN_Grm8+_2
HIGD2A	MSN_Grm8+_2
HIGD2B	MSN_Grm8+_2
INPP4B	MSN_Grm8+_2
KDM5D	MSN_Grm8+_2
L1CAM	MSN_Grm8+_2
LAMTOR2	MSN_Grm8+_2
LRRTM3	MSN_Grm8+_2
MAGED1	MSN_Grm8+_2
MTCH1	MSN_Grm8+_2
NELL2	MSN_Grm8+_2
NOMO2	MSN_Grm8+_2
NOMO3	MSN_Grm8+_2
NOMO1	MSN_Grm8+_2
PCBP4	MSN_Grm8+_2
PDE1A	MSN_Grm8+_2
PHACTR1	MSN_Grm8+_2
PLP1	MSN_Grm8+_2
PTN	MSN_Grm8+_2
PTPRE	MSN_Grm8+_2
RGS9	MSN_Grm8+_2
RPN2	MSN_Grm8+_2
RPTOR	MSN_Grm8+_2
RTN1	MSN_Grm8+_2
SARAF	MSN_Grm8+_2
SST	MSN_Grm8+_2
SYNPR	MSN_Grm8+_2
SYT17	MSN_Grm8+_2
SYT4	MSN_Grm8+_2
TSPAN13	MSN_Grm8+_2
TSPAN2	MSN_Grm8+_2
ZCCHC17	MSN_Grm8+_2
ARPP21	Neuroblast
PHACTR1	Neuroblast
PTPRD	Neuroblast
C2orf88	Oligodendrocytes
C15orf61	Oligodendrocytes
C16orf87	Oligodendrocytes
KIAA0408	Oligodendrocytes
C10orf143	Oligodendrocytes
AAK1	Oligodendrocytes
AASDHPPT	Oligodendrocytes
ABAT	Oligodendrocytes
ABHD11	Oligodendrocytes
ABHD3	Oligodendrocytes
ACO2	Oligodendrocytes
ACSL3	Oligodendrocytes
ACTB	Oligodendrocytes
ACTR1B	Oligodendrocytes
ACVR1	Oligodendrocytes
ADARB2	Oligodendrocytes
ADH5	Oligodendrocytes
ADIPOR2	Oligodendrocytes
AFF2	Oligodendrocytes
AFF3	Oligodendrocytes
AGFG2	Oligodendrocytes
AGO2	Oligodendrocytes
AGPAT4	Oligodendrocytes
AGPAT5	Oligodendrocytes
AHDC1	Oligodendrocytes
AIMP1	Oligodendrocytes
AK2	Oligodendrocytes
TAF9	Oligodendrocytes
AKAP11	Oligodendrocytes
AKR7L	Oligodendrocytes
ALCAM	Oligodendrocytes
ALG3	Oligodendrocytes
ALYREF	Oligodendrocytes
AMPD2	Oligodendrocytes
ANAPC7	Oligodendrocytes
ANKRD13A	Oligodendrocytes
ANP32D	Oligodendrocytes
ANP32A	Oligodendrocytes
ANP32E	Oligodendrocytes
AP1AR	Oligodendrocytes
AP1S2	Oligodendrocytes
AP3M2	Oligodendrocytes
APBB3	Oligodendrocytes
APLP1	Oligodendrocytes
APLP2	Oligodendrocytes
APOD	Oligodendrocytes
APOE	Oligodendrocytes
ARF4	Oligodendrocytes
ARGLU1	Oligodendrocytes
ARHGAP33	Oligodendrocytes
ARHGEF19	Oligodendrocytes
ARID4A	Oligodendrocytes
ARID5B	Oligodendrocytes
ARL3	Oligodendrocytes
ARL6IP1	Oligodendrocytes
ARMC1	Oligodendrocytes
ARMCX5	Oligodendrocytes
ARPC1A	Oligodendrocytes
ARRDC2	Oligodendrocytes
ARRDC3	Oligodendrocytes
ARVCF	Oligodendrocytes
ASRGL1	Oligodendrocytes
ATAD1	Oligodendrocytes
ATAT1	Oligodendrocytes
ATF4	Oligodendrocytes
ATF6B	Oligodendrocytes
ATG101	Oligodendrocytes
ATL1	Oligodendrocytes
ATL2	Oligodendrocytes
ATN1	Oligodendrocytes
ATOX1	Oligodendrocytes
ATP11A	Oligodendrocytes
ATP5F1A	Oligodendrocytes
ATP8A2	Oligodendrocytes
ATRAID	Oligodendrocytes
ATXN1	Oligodendrocytes
ATXN7L3B	Oligodendrocytes
AUP1	Oligodendrocytes
AZIN1	Oligodendrocytes
C5orf24	Oligodendrocytes
B2M	Oligodendrocytes
B3GAT1	Oligodendrocytes
B3GAT2	Oligodendrocytes
B9D1	Oligodendrocytes
BANP	Oligodendrocytes
BAP1	Oligodendrocytes
BBS7	Oligodendrocytes
C18orf32	Oligodendrocytes
BCAT1	Oligodendrocytes
BCCIP	Oligodendrocytes
BCL2L1	Oligodendrocytes
BICRAL	Oligodendrocytes
BNIP3	Oligodendrocytes
BTBD2	Oligodendrocytes
BTF3	Oligodendrocytes
BZW1	Oligodendrocytes
CACNA2D1	Oligodendrocytes
CADM2	Oligodendrocytes
CADM4	Oligodendrocytes
CAMSAP1	Oligodendrocytes
CANX	Oligodendrocytes
CA2	Oligodendrocytes
CASD1	Oligodendrocytes
CBX4	Oligodendrocytes
CBX5	Oligodendrocytes
CBY1	Oligodendrocytes
CCDC24	Oligodendrocytes
CCT3	Oligodendrocytes
CCT5	Oligodendrocytes
CD81	Oligodendrocytes
CDC37L1	Oligodendrocytes
CDC42BPA	Oligodendrocytes
CDH2	Oligodendrocytes
CDH20	Oligodendrocytes
CDIPT	Oligodendrocytes
CDK17	Oligodendrocytes
CDK8	Oligodendrocytes
CDKL3	Oligodendrocytes
CDON	Oligodendrocytes
CEP126	Oligodendrocytes
CETN3	Oligodendrocytes
CFAP20	Oligodendrocytes
CFL1	Oligodendrocytes
CGGBP1	Oligodendrocytes
CHD4	Oligodendrocytes
CIPC	Oligodendrocytes
CKB	Oligodendrocytes
CLCN3	Oligodendrocytes
CLDND1	Oligodendrocytes
CLEC16A	Oligodendrocytes
CLIP3	Oligodendrocytes
CLK1	Oligodendrocytes
CLMN	Oligodendrocytes
CLTC	Oligodendrocytes
CMSS1	Oligodendrocytes
CNP	Oligodendrocytes
COPG1	Oligodendrocytes
COPS4	Oligodendrocytes
COQ10B	Oligodendrocytes
COQ2	Oligodendrocytes
COX19	Oligodendrocytes
COX20	Oligodendrocytes
COX6C	Oligodendrocytes
CPSF1	Oligodendrocytes
CPT1C	Oligodendrocytes
CRTAC1	Oligodendrocytes
CRYAB	Oligodendrocytes
CRYZL1	Oligodendrocytes
CSNK1G2	Oligodendrocytes
CTSZ	Oligodendrocytes
CTTN	Oligodendrocytes
CUTA	Oligodendrocytes
CUTC	Oligodendrocytes
CYLD	Oligodendrocytes
CYREN	Oligodendrocytes
C19orf53	Oligodendrocytes
DAAM2	Oligodendrocytes
DAP3	Oligodendrocytes
DBI	Oligodendrocytes
DBNDD2	Oligodendrocytes
DCAF11	Oligodendrocytes
DCLK2	Oligodendrocytes
DDB1	Oligodendrocytes
DDRGK1	Oligodendrocytes
DDX17	Oligodendrocytes
DDX24	Oligodendrocytes
DEGS1	Oligodendrocytes
DHX9	Oligodendrocytes
DIAPH2	Oligodendrocytes
DMD	Oligodendrocytes
DMXL2	Oligodendrocytes
DNAJA2	Oligodendrocytes
DNAJB11	Oligodendrocytes
DNAJB4	Oligodendrocytes
DNAJB9	Oligodendrocytes
DNAJC14	Oligodendrocytes
DNAJC15	Oligodendrocytes
DNAJC30	Oligodendrocytes
DNM1L	Oligodendrocytes
DOCK9	Oligodendrocytes
DR1	Oligodendrocytes
DRAP1	Oligodendrocytes
DSTN	Oligodendrocytes
DTD1	Oligodendrocytes
DVL2	Oligodendrocytes
DYNLRB1	Oligodendrocytes
DYNLT3	Oligodendrocytes
DZIP3	Oligodendrocytes
EBAG9	Oligodendrocytes
EDC4	Oligodendrocytes
EEF1D	Oligodendrocytes
EHMT2	Oligodendrocytes
EIF1	Oligodendrocytes
EIF2B4	Oligodendrocytes
EIF4G2	Oligodendrocytes
ELK1	Oligodendrocytes
EMC1	Oligodendrocytes
EMC10	Oligodendrocytes
EMC3	Oligodendrocytes
EMD	Oligodendrocytes
EML4	Oligodendrocytes
ENAH	Oligodendrocytes
ENDOV	Oligodendrocytes
EPB41L1	Oligodendrocytes
EPB41L4B	Oligodendrocytes
EPN1	Oligodendrocytes
ERC1	Oligodendrocytes
ERGIC3	Oligodendrocytes
ERMN	Oligodendrocytes
ETHE1	Oligodendrocytes
EXD2	Oligodendrocytes
EXOSC4	Oligodendrocytes
FABP5	Oligodendrocytes
FAM104B	Oligodendrocytes
FAM171B	Oligodendrocytes
FAM98B	Oligodendrocytes
FAR2	Oligodendrocytes
FASTK	Oligodendrocytes
FAU	Oligodendrocytes
FBH1	Oligodendrocytes
FBXL14	Oligodendrocytes
FBXO10	Oligodendrocytes
FBXO25	Oligodendrocytes
FBXO31	Oligodendrocytes
FBXO45	Oligodendrocytes
FBXO7	Oligodendrocytes
FBXO9	Oligodendrocytes
FBXW12	Oligodendrocytes
FBXW5	Oligodendrocytes
FBXW7	Oligodendrocytes
FEZ1	Oligodendrocytes
FILIP1L	Oligodendrocytes
FIS1	Oligodendrocytes
FKBP1C	Oligodendrocytes
FKBP1A	Oligodendrocytes
FKBP5	Oligodendrocytes
FLYWCH1	Oligodendrocytes
FMN1	Oligodendrocytes
FNDC3B	Oligodendrocytes
FOCAD	Oligodendrocytes
FOXP1	Oligodendrocytes
FTH1	Oligodendrocytes
FTL	Oligodendrocytes
FZR1	Oligodendrocytes
G3BP1	Oligodendrocytes
GABARAP	Oligodendrocytes
GABBR1	Oligodendrocytes
GDE1	Oligodendrocytes
GGT7	Oligodendrocytes
GJB1	Oligodendrocytes
SNURF	Oligodendrocytes
GMFB	Oligodendrocytes
GNA11	Oligodendrocytes
GNB1	Oligodendrocytes
GNG7	Oligodendrocytes
GOLGB1	Oligodendrocytes
GPATCH11	Oligodendrocytes
GPR137	Oligodendrocytes
GPR37	Oligodendrocytes
GPR61	Oligodendrocytes
GPRASP1	Oligodendrocytes
GPS1	Oligodendrocytes
GRIPAP1	Oligodendrocytes
GRK2	Oligodendrocytes
GSK3B	Oligodendrocytes
GSN	Oligodendrocytes
GSTM3	Oligodendrocytes
GSTP1	Oligodendrocytes
GTF2H5	Oligodendrocytes
GTF2IRD1	Oligodendrocytes
GTF3C5	Oligodendrocytes
HLA-E	Oligodendrocytes
HLA-E	Oligodendrocytes
H3-3A	Oligodendrocytes
H3-5	Oligodendrocytes
H3-3B	Oligodendrocytes
HACD3	Oligodendrocytes
HAGH	Oligodendrocytes
HAGHL	Oligodendrocytes
HAPLN2	Oligodendrocytes
HDAC2	Oligodendrocytes
HDAC3	Oligodendrocytes
HDGF	Oligodendrocytes
HECW2	Oligodendrocytes
HELZ	Oligodendrocytes
HEPACAM	Oligodendrocytes
HIF3A	Oligodendrocytes
HIRIP3	Oligodendrocytes
HMGCS1	Oligodendrocytes
HNRNPA1	Oligodendrocytes
HNRNPD	Oligodendrocytes
HNRNPK	Oligodendrocytes
HP1BP3	Oligodendrocytes
HSD17B10	Oligodendrocytes
HSP90AA1	Oligodendrocytes
HSP90AB1	Oligodendrocytes
HSP90B1	Oligodendrocytes
HSPA4	Oligodendrocytes
HSPA4L	Oligodendrocytes
HSPA9	Oligodendrocytes
HSPH1	Oligodendrocytes
HTRA1	Oligodendrocytes
ICMT	Oligodendrocytes
IDH3B	Oligodendrocytes
IGF2R	Oligodendrocytes
IGIP	Oligodendrocytes
IGSF8	Oligodendrocytes
IKZF2	Oligodendrocytes
IL1RAPL1	Oligodendrocytes
IMPACT	Oligodendrocytes
IMPDH2	Oligodendrocytes
INPP5J	Oligodendrocytes
INTS10	Oligodendrocytes
ITM2B	Oligodendrocytes
ITPK1	Oligodendrocytes
IVNS1ABP	Oligodendrocytes
JAK1	Oligodendrocytes
JUND	Oligodendrocytes
KAT5	Oligodendrocytes
KCTD16	Oligodendrocytes
KCTD20	Oligodendrocytes
KCTD3	Oligodendrocytes
KDELR1	Oligodendrocytes
KIF2A	Oligodendrocytes
KIT	Oligodendrocytes
KLC1	Oligodendrocytes
KLF9	Oligodendrocytes
KLHL13	Oligodendrocytes
KLHL7	Oligodendrocytes
KMT2A	Oligodendrocytes
KMT2B	Oligodendrocytes
L3MBTL3	Oligodendrocytes
LAMP1	Oligodendrocytes
LAMTOR3	Oligodendrocytes
LAMTOR5	Oligodendrocytes
LARS2	Oligodendrocytes
LAS1L	Oligodendrocytes
LEPROTL1	Oligodendrocytes
LIG3	Oligodendrocytes
LINGO2	Oligodendrocytes
LLPH	Oligodendrocytes
LMNA	Oligodendrocytes
LONP1	Oligodendrocytes
LRRC45	Oligodendrocytes
LSM1	Oligodendrocytes
LSM6	Oligodendrocytes
LSM7	Oligodendrocytes
LUZP2	Oligodendrocytes
LYSMD4	Oligodendrocytes
MAGOH	Oligodendrocytes
MAL	Oligodendrocytes
MAN2A1	Oligodendrocytes
MAP2K1	Oligodendrocytes
MAP3K10	Oligodendrocytes
MAP3K12	Oligodendrocytes
MAP7D2	Oligodendrocytes
MAPK1	Oligodendrocytes
MAPKBP1	Oligodendrocytes
MAST3	Oligodendrocytes
MAT2A	Oligodendrocytes
MATN4	Oligodendrocytes
MATR3	Oligodendrocytes
MCRS1	Oligodendrocytes
MEAF6	Oligodendrocytes
MECR	Oligodendrocytes
MED19	Oligodendrocytes
MED24	Oligodendrocytes
MED30	Oligodendrocytes
MEN1	Oligodendrocytes
METTL23	Oligodendrocytes
MFN2	Oligodendrocytes
MIA3	Oligodendrocytes
MID1IP1	Oligodendrocytes
MID2	Oligodendrocytes
MIGA1	Oligodendrocytes
MINK1	Oligodendrocytes
MOBP	Oligodendrocytes
MORF4L2	Oligodendrocytes
MPHOSPH8	Oligodendrocytes
MPRIP	Oligodendrocytes
MRFAP1L1	Oligodendrocytes
MRFAP1	Oligodendrocytes
MRM3	Oligodendrocytes
MROH1	Oligodendrocytes
MRPL13	Oligodendrocytes
MRPL32	Oligodendrocytes
MRPL33	Oligodendrocytes
MRPL38	Oligodendrocytes
MRPL58	Oligodendrocytes
MRPS21	Oligodendrocytes
MRPS24	Oligodendrocytes
MRTFB	Oligodendrocytes
MSANTD4	Oligodendrocytes
MSL1	Oligodendrocytes
MSRA	Oligodendrocytes
MTHFD2L	Oligodendrocytes
MTMR2	Oligodendrocytes
MTPN	Oligodendrocytes
MTX3	Oligodendrocytes
MUL1	Oligodendrocytes
MYO5A	Oligodendrocytes
MYPOP	Oligodendrocytes
NAA50	Oligodendrocytes
NAPG	Oligodendrocytes
NCEH1	Oligodendrocytes
NCL	Oligodendrocytes
NDRG3	Oligodendrocytes
NDUFS4	Oligodendrocytes
NFU1	Oligodendrocytes
NIPAL3	Oligodendrocytes
NKX6-2	Oligodendrocytes
NLGN1	Oligodendrocytes
NOP58	Oligodendrocytes
NOS1AP	Oligodendrocytes
NT5C3B	Oligodendrocytes
NUCKS1	Oligodendrocytes
NUDT3	Oligodendrocytes
NUP43	Oligodendrocytes
NUP50	Oligodendrocytes
NXT1	Oligodendrocytes
OGFOD1	Oligodendrocytes
OPCML	Oligodendrocytes
OSGEP	Oligodendrocytes
OTUD7A	Oligodendrocytes
PAK1IP1	Oligodendrocytes
PAK3	Oligodendrocytes
PALM2AKAP2	Oligodendrocytes
PCLO	Oligodendrocytes
PCMT1	Oligodendrocytes
PDCD4	Oligodendrocytes
PDE4B	Oligodendrocytes
PDE8B	Oligodendrocytes
PDHB	Oligodendrocytes
PDIA3	Oligodendrocytes
PDIA4	Oligodendrocytes
PDK2	Oligodendrocytes
PDPK1	Oligodendrocytes
PDXK	Oligodendrocytes
PDZD8	Oligodendrocytes
PEX5L	Oligodendrocytes
PFDN6	Oligodendrocytes
PFN1	Oligodendrocytes
PGBD5	Oligodendrocytes
PGM1	Oligodendrocytes
PGS1	Oligodendrocytes
PHAX	Oligodendrocytes
PHLDB1	Oligodendrocytes
PHYHIPL	Oligodendrocytes
PIGH	Oligodendrocytes
PIK3R2	Oligodendrocytes
PISD	Oligodendrocytes
PJA2	Oligodendrocytes
PKM	Oligodendrocytes
PLA2G3	Oligodendrocytes
PLEKHF1	Oligodendrocytes
PLEKHM2	Oligodendrocytes
PLIN4	Oligodendrocytes
PLP1	Oligodendrocytes
PLPBP	Oligodendrocytes
PLPP7	Oligodendrocytes
PMPCA	Oligodendrocytes
PNRC1	Oligodendrocytes
POLR2F	Oligodendrocytes
POLR3E	Oligodendrocytes
POU3F1	Oligodendrocytes
PPA2	Oligodendrocytes
PPAN	Oligodendrocytes
PPAN-P2RY11	Oligodendrocytes
PPFIA2	Oligodendrocytes
PPIB	Oligodendrocytes
PPM1G	Oligodendrocytes
PPP1R12C	Oligodendrocytes
PPP1R14A	Oligodendrocytes
PPP1R16B	Oligodendrocytes
PPP3CA	Oligodendrocytes
PPTC7	Oligodendrocytes
PRADC1	Oligodendrocytes
PRDX1	Oligodendrocytes
PRKCSH	Oligodendrocytes
PRMT7	Oligodendrocytes
PRNP	Oligodendrocytes
PRRC2A	Oligodendrocytes
PSENEN	Oligodendrocytes
PSIP1	Oligodendrocytes
PSMA1	Oligodendrocytes
PSMA5	Oligodendrocytes
PSMB1	Oligodendrocytes
PSMB3	Oligodendrocytes
PSMC3	Oligodendrocytes
PSMD12	Oligodendrocytes
PSMD6	Oligodendrocytes
PSME4	Oligodendrocytes
PTCD2	Oligodendrocytes
PTN	Oligodendrocytes
PTPN9	Oligodendrocytes
PURA	Oligodendrocytes
QDPR	Oligodendrocytes
QPCT	Oligodendrocytes
RAB14	Oligodendrocytes
RAB24	Oligodendrocytes
RAB31	Oligodendrocytes
RAB33A	Oligodendrocytes
RAB37	Oligodendrocytes
RAB5C	Oligodendrocytes
RAC1	Oligodendrocytes
RAD23A	Oligodendrocytes
RAE1	Oligodendrocytes
RAPH1	Oligodendrocytes
RBCK1	Oligodendrocytes
RBFA	Oligodendrocytes
RCAN2	Oligodendrocytes
RDH10	Oligodendrocytes
RER1	Oligodendrocytes
RHBDD3	Oligodendrocytes
RHEB	Oligodendrocytes
RHOA	Oligodendrocytes
RHOB	Oligodendrocytes
RHOG	Oligodendrocytes
RHOJ	Oligodendrocytes
RHPN2	Oligodendrocytes
RIPK2	Oligodendrocytes
RNF139	Oligodendrocytes
RNF7	Oligodendrocytes
RNH1	Oligodendrocytes
ROCK2	Oligodendrocytes
RPA1	Oligodendrocytes
RPAP3	Oligodendrocytes
RPL18	Oligodendrocytes
RPL28	Oligodendrocytes
RPL6	Oligodendrocytes
RPL8	Oligodendrocytes
RPS2	Oligodendrocytes
RPS21	Oligodendrocytes
RPS23	Oligodendrocytes
RPS24	Oligodendrocytes
RPS5	Oligodendrocytes
RPS8	Oligodendrocytes
RPS9	Oligodendrocytes
RPSAP58	Oligodendrocytes
RPSA	Oligodendrocytes
RRP1B	Oligodendrocytes
RSRP1	Oligodendrocytes
RTKN	Oligodendrocytes
RUNDC1	Oligodendrocytes
RUNDC3B	Oligodendrocytes
RWDD1	Oligodendrocytes
SAE1	Oligodendrocytes
SC5D	Oligodendrocytes
SCD	Oligodendrocytes
SCOC	Oligodendrocytes
SDAD1	Oligodendrocytes
SDF2	Oligodendrocytes
SDHA	Oligodendrocytes
SEC62	Oligodendrocytes
SEH1L	Oligodendrocytes
SELENOF	Oligodendrocytes
SELENOI	Oligodendrocytes
SELENOK	Oligodendrocytes
SELENOS	Oligodendrocytes
SEM1	Oligodendrocytes
SERINC1	Oligodendrocytes
SERP1	Oligodendrocytes
SF3B2	Oligodendrocytes
SGK1	Oligodendrocytes
SH3GLB1	Oligodendrocytes
SHISA8	Oligodendrocytes
SIN3B	Oligodendrocytes
SLC22A17	Oligodendrocytes
SLC22A23	Oligodendrocytes
SLC25A39	Oligodendrocytes
SLC39A14	Oligodendrocytes
SLC3A2	Oligodendrocytes
SLC6A1	Oligodendrocytes
SMAD3	Oligodendrocytes
SMIM11B	Oligodendrocytes
SMIM11A	Oligodendrocytes
SMIM19	Oligodendrocytes
SMIM26	Oligodendrocytes
SMIM8	Oligodendrocytes
SMPD4	Oligodendrocytes
SNAP91	Oligodendrocytes
SNAPC1	Oligodendrocytes
SNRK	Oligodendrocytes
SNRPA1	Oligodendrocytes
SNRPF	Oligodendrocytes
SNX32	Oligodendrocytes
SON	Oligodendrocytes
SORBS1	Oligodendrocytes
SORCS1	Oligodendrocytes
SPATS2L	Oligodendrocytes
SPEF2	Oligodendrocytes
SPG7	Oligodendrocytes
SPTBN1	Oligodendrocytes
SQLE	Oligodendrocytes
SREK1IP1	Oligodendrocytes
SRP9	Oligodendrocytes
SRPRA	Oligodendrocytes
SRSF2	Oligodendrocytes
SRSF3	Oligodendrocytes
SRSF9	Oligodendrocytes
SSB	Oligodendrocytes
SSBP2	Oligodendrocytes
SSBP3	Oligodendrocytes
SSR3	Oligodendrocytes
SSR4	Oligodendrocytes
ST3GAL3	Oligodendrocytes
STAMBP	Oligodendrocytes
STIP1	Oligodendrocytes
STK16	Oligodendrocytes
STMN1	Oligodendrocytes
STMN4	Oligodendrocytes
STXBP6	Oligodendrocytes
SUCLA2	Oligodendrocytes
SUDS3	Oligodendrocytes
SUGP2	Oligodendrocytes
SUPT4H1	Oligodendrocytes
SUPT6H	Oligodendrocytes
SURF1	Oligodendrocytes
SV2A	Oligodendrocytes
SVIL	Oligodendrocytes
SYNJ2BP	Oligodendrocytes
SYPL1	Oligodendrocytes
SYT11	Oligodendrocytes
TALDO1	Oligodendrocytes
TAX1BP1	Oligodendrocytes
TBC1D20	Oligodendrocytes
TBCA	Oligodendrocytes
TBCC	Oligodendrocytes
TBPL1	Oligodendrocytes
TCF25	Oligodendrocytes
TCP1	Oligodendrocytes
TECR	Oligodendrocytes
TERF2IP	Oligodendrocytes
TFRC	Oligodendrocytes
TGOLN2	Oligodendrocytes
THAP7	Oligodendrocytes
THOC7	Oligodendrocytes
THSD7A	Oligodendrocytes
THYN1	Oligodendrocytes
TIMM9	Oligodendrocytes
TIMP2	Oligodendrocytes
TKT	Oligodendrocytes
TLE4	Oligodendrocytes
TLN1	Oligodendrocytes
TM9SF3	Oligodendrocytes
TM9SF4	Oligodendrocytes
TMBIM6	Oligodendrocytes
TMCO1	Oligodendrocytes
TMED3	Oligodendrocytes
TMED4	Oligodendrocytes
TMEM101	Oligodendrocytes
TMEM106B	Oligodendrocytes
TMEM106C	Oligodendrocytes
TMEM18	Oligodendrocytes
TMEM183A	Oligodendrocytes
TMEM199	Oligodendrocytes
TMEM205	Oligodendrocytes
TMEM222	Oligodendrocytes
TMEM223	Oligodendrocytes
TMEM237	Oligodendrocytes
TMEM263	Oligodendrocytes
TMEM30A	Oligodendrocytes
TMEM33	Oligodendrocytes
TMEM50B	Oligodendrocytes
TMEM94	Oligodendrocytes
TMEM9B	Oligodendrocytes
TMOD2	Oligodendrocytes
TMSB4Y	Oligodendrocytes
TMX1	Oligodendrocytes
TNKS2	Oligodendrocytes
TNPO2	Oligodendrocytes
TOB2	Oligodendrocytes
TOP1	Oligodendrocytes
TPGS2	Oligodendrocytes
TPRG1L	Oligodendrocytes
TPT1	Oligodendrocytes
TRAPPC2B	Oligodendrocytes
TRAPPC2	Oligodendrocytes
TRAPPC3	Oligodendrocytes
TF	Oligodendrocytes
TRIM39	Oligodendrocytes
TRMT1	Oligodendrocytes
TRNAU1AP	Oligodendrocytes
TP53BP1	Oligodendrocytes
TP53RK	Oligodendrocytes
TSEN15	Oligodendrocytes
TSEN34	Oligodendrocytes
TSNAX-DISC1	Oligodendrocytes
TSPAN7	Oligodendrocytes
TTC9	Oligodendrocytes
TTYH1	Oligodendrocytes
TUBA1A	Oligodendrocytes
TVP23C-CDRT4	Oligodendrocytes
TXNDC15	Oligodendrocytes
TXNDC17	Oligodendrocytes
TXNRD1	Oligodendrocytes
UBA6	Oligodendrocytes
UBB	Oligodendrocytes
UBC	Oligodendrocytes
UBE2B	Oligodendrocytes
UBE2O	Oligodendrocytes
UBE3A	Oligodendrocytes
UBP1	Oligodendrocytes
UBR5	Oligodendrocytes
UCK1	Oligodendrocytes
UFC1	Oligodendrocytes
UFM1	Oligodendrocytes
UHMK1	Oligodendrocytes
UNC13B	Oligodendrocytes
UNC50	Oligodendrocytes
UQCRC2	Oligodendrocytes
USP13	Oligodendrocytes
USP14	Oligodendrocytes
USP19	Oligodendrocytes
USP5	Oligodendrocytes
VEGFB	Oligodendrocytes
VHL	Oligodendrocytes
VHLL	Oligodendrocytes
VMA21	Oligodendrocytes
VMP1	Oligodendrocytes
VOPP1	Oligodendrocytes
WDR12	Oligodendrocytes
WDR20	Oligodendrocytes
WDR47	Oligodendrocytes
WDR61	Oligodendrocytes
WDR75	Oligodendrocytes
XAB2	Oligodendrocytes
XRCC6	Oligodendrocytes
YBX1	Oligodendrocytes
YIF1B	Oligodendrocytes
YWHAG	Oligodendrocytes
ZBTB16	Oligodendrocytes
ZBTB18	Oligodendrocytes
ZBTB7A	Oligodendrocytes
ZC3H15	Oligodendrocytes
ZC3H6	Oligodendrocytes
ZCCHC14	Oligodendrocytes
ZCCHC17	Oligodendrocytes
ZCCHC7	Oligodendrocytes
ZDHHC12	Oligodendrocytes
ZDHHC16	Oligodendrocytes
ZDHHC20	Oligodendrocytes
ZFAND4	Oligodendrocytes
ZNF276	Oligodendrocytes
ZNF444	Oligodendrocytes
ZNF226	Oligodendrocytes
ZNF23	Oligodendrocytes
ZNF638	Oligodendrocytes
ZNF654	Oligodendrocytes
ZNF664	Oligodendrocytes
ZMAT2	Oligodendrocytes
ZMIZ2	Oligodendrocytes
C12orf43	OPC
C6orf136	OPC
C8orf34	OPC
AAMP	OPC
ABCA2	OPC
ABCF1	OPC
ABCF2	OPC
ABCF2-H2BE1	OPC
ACAP3	OPC
ACHE	OPC
ACSL3	OPC
ADAM11	OPC
ADGRL1	OPC
ADGRL2	OPC
ADSS2	OPC
AFG3L2	OPC
AGAP2	OPC
AHI1	OPC
C11orf68	OPC
AKAP11	OPC
ALDOC	OPC
ALG10	OPC
ALG10B	OPC
AMD1	OPC
ANKRD50	OPC
AP1S2	OPC
AP2A1	OPC
APBB2	OPC
APOE	OPC
APP	OPC
ARHGAP31	OPC
ARHGAP33	OPC
ARL1	OPC
ARMC1	OPC
ARPC2	OPC
ARPP21	OPC
ASIC2	OPC
ATOX1	OPC
ATP5F1A	OPC
ATP5MC2	OPC
ATP6V1A	OPC
ATP6V1B2	OPC
ATP6V1D	OPC
ATP9A	OPC
ATRX	OPC
ATXN7L3B	OPC
BAD	OPC
BANF1	OPC
BAX	OPC
BCAS2	OPC
BCR	OPC
BHLHB9	OPC
BHLHE41	OPC
BLOC1S6	OPC
BNIP3	OPC
BNIP3L	OPC
BORCS6	OPC
BRI3	OPC
BRI3BP	OPC
BTG3	OPC
BZW1	OPC
C1D	OPC
CACFD1	OPC
CACNA2D2	OPC
CACNA2D3	OPC
CACYBP	OPC
CAMK4	OPC
CAMKK2	OPC
CANX	OPC
CASD1	OPC
CBY1	OPC
CCDC112	OPC
CCDC47	OPC
CCNG2	OPC
CCT4	OPC
CD81	OPC
CDC42EP3	OPC
CDH9	OPC
CELF3	OPC
CELF4	OPC
CHMP1A	OPC
CHMP2B	OPC
CHST15	OPC
CLDND1	OPC
CLTA	OPC
CLU	OPC
CMAS	OPC
CNOT11	OPC
CNTNAP2	OPC
COPB2	OPC
COPS6	OPC
COPS7A	OPC
COX18	OPC
COX7C	OPC
CPNE8	OPC
CPSF2	OPC
CREG2	OPC
CSNK1E	OPC
TPTEP2-CSNK1E	OPC
CSNK1G2	OPC
CUTA	OPC
CYB5A	OPC
CYC1	OPC
CYP51A1	OPC
CYP7B1	OPC
CYTH2	OPC
DAP3	OPC
DBNL	OPC
DBR1	OPC
DCAF13	OPC
DDRGK1	OPC
DDX24	OPC
DDX27	OPC
DENR	OPC
DGCR2	OPC
DIRAS2	OPC
DLD	OPC
DNAJA2	OPC
DNAJB11	OPC
DNAJC30	OPC
DNAJC8	OPC
DNLZ	OPC
DPH6	OPC
DRAP1	OPC
DYNLL1	OPC
DZANK1	OPC
EBNA1BP2	OPC
EEF1A1	OPC
EEF1E1	OPC
EGLN2	OPC
EID2B	OPC
EIF1B	OPC
EIF3C	OPC
EIF3CL	OPC
ELK1	OPC
ELOC	OPC
EMB	OPC
EMC10	OPC
ENO1	OPC
EPHA4	OPC
EPRS1	OPC
ERF	OPC
ESF1	OPC
FAM171B	OPC
FAM193B	OPC
FAM20B	OPC
FAM20C	OPC
FAM216A	OPC
FAM98B	OPC
FAM98C	OPC
FBXW7	OPC
FEM1A	OPC
FEM1B	OPC
FKBP4	OPC
FKBP5	OPC
FMC1	OPC
FNBP4	OPC
FOXP1	OPC
FOXP2	OPC
FSD1	OPC
FZD3	OPC
G3BP2	OPC
GABARAP	OPC
GABARAPL2	OPC
GABBR1	OPC
GABRG3	OPC
GCSH	OPC
GIT1	OPC
GLO1	OPC
GLS	OPC
C11orf96	OPC
GNL3L	OPC
GOLGB1	OPC
GPR85	OPC
GRIA1	OPC
GRIA4	OPC
GRINA	OPC
GRK3	OPC
H3-5	OPC
H3-3B	OPC
HAGH	OPC
HINT2	OPC
HNRNPA0	OPC
HNRNPA1	OPC
HNRNPD	OPC
HNRNPUL2-BSCL2	OPC
HNRNPUL2	OPC
HOMER1	OPC
HP1BP3	OPC
HS3ST5	OPC
HS6ST2	OPC
HS6ST3	OPC
HSPA12A	OPC
HSPA4L	OPC
HSPA9	OPC
HSPH1	OPC
HYOU1	OPC
HYPK	OPC
IDH3A	OPC
IDH3G	OPC
IMPA1	OPC
IMPDH1	OPC
INTS1	OPC
IPO4	OPC
IRAK1BP1	OPC
IRF2BP1	OPC
IRGQ	OPC
ITGB1BP1	OPC
ITPR1	OPC
JOSD1	OPC
KBTBD11	OPC
KCNA1	OPC
KCNQ2	OPC
KCNQ5	OPC
KCTD1	OPC
KCTD13	OPC
KCTD17	OPC
KIF1A	OPC
KIF5C	OPC
KIFAP3	OPC
KLC1	OPC
KLF9	OPC
KLHL2	OPC
KLHL8	OPC
KPNA1	OPC
KPNB1	OPC
KPTN	OPC
KRT10	OPC
LACTB	OPC
LAMTOR2	OPC
LAMTOR4	OPC
LCMT1	OPC
LEPROTL1	OPC
LGALSL	OPC
LINGO2	OPC
LMAN2L	OPC
LMO4	OPC
LRFN4	OPC
LRRC59	OPC
LRRC8C	OPC
LRRTM2	OPC
M6PR	OPC
MAGED1	OPC
MAGEH1	OPC
MANBAL	OPC
MAP1B	OPC
MAP2K1	OPC
MAP7D1	OPC
MAPK8IP1	OPC
MAST3	OPC
MAT2B	OPC
MATR3	OPC
MBNL1	OPC
MBOAT7	OPC
MCRS1	OPC
MED8	OPC
MFN2	OPC
MGAT2	OPC
MGAT4C	OPC
MINK1	OPC
MLLT11	OPC
MORF4L1	OPC
MPC1	OPC
MPI	OPC
MRPL16	OPC
MRPL17	OPC
MRPL19	OPC
MRPL27	OPC
MRPL32	OPC
MRPL43	OPC
MRPL54	OPC
MRPS16	OPC
MRPS21	OPC
MRPS24	OPC
MRPS26	OPC
MRPS33	OPC
MRTO4	OPC
MTLN	OPC
MTREX	OPC
MYH10	OPC
NACA	OPC
NALCN	OPC
NAMPT	OPC
NAPB	OPC
NARS1	OPC
NCAM2	OPC
NCL	OPC
NDST1	OPC
NDUFA10	OPC
NDUFA9	OPC
NDUFB3	OPC
NDUFB4	OPC
NDUFS3	OPC
NDUFV3	OPC
NEDD8	OPC
NELL2	OPC
NFASC	OPC
NIPAL3	OPC
NKIRAS1	OPC
NOP53	OPC
NOVA1	OPC
NPDC1	OPC
NRG1	OPC
NSF	OPC
NTNG1	OPC
NUCKS1	OPC
NUDT11	OPC
NUDT19	OPC
NUMA1	OPC
OAZ1	OPC
OGFRL1	OPC
OLA1	OPC
OSBPL8	OPC
OST4	OPC
OSTC	OPC
OXCT1	OPC
PAK1IP1	OPC
PALM	OPC
PCBP1	OPC
PCDHB14	OPC
PCSK2	OPC
PDAP1	OPC
PDCD5	OPC
PDCD6	OPC
PDE10A	OPC
PDE1C	OPC
PDE4A	OPC
PDIA3	OPC
PDIA4	OPC
PDIA6	OPC
PDRG1	OPC
PER1	OPC
PFDN2	OPC
PFN1	OPC
PHAX	OPC
PHB2	OPC
PHYKPL	OPC
PIP4K2B	OPC
PITHD1	OPC
PJA2	OPC
PLAT	OPC
PMEPA1	OPC
PMPCB	OPC
PNRC1	OPC
POLR1D	OPC
POLR2M	OPC
POR	OPC
PPA1	OPC
PPP1R11	OPC
PPP2R1A	OPC
PPP3CA	OPC
PPP3CB	OPC
PRELID1	OPC
PRKACB	OPC
PRKAR1B	OPC
PRKAR2B	OPC
PRMT1	OPC
PRPF19	OPC
PRR12	OPC
PSAP	OPC
PSENEN	OPC
PSMA1	OPC
PSMA4	OPC
PSMB7	OPC
PSMC2	OPC
PSMC3	OPC
PSMD4	OPC
PSMD6	OPC
PSMD7	OPC
PTGDS	OPC
PTN	OPC
PTOV1	OPC
PURB	OPC
QSOX2	OPC
RAB11FIP4	OPC
RAB14	OPC
RAB18	OPC
RAB1B	OPC
RAB24	OPC
TGIF2-RAB5IF	OPC
RAB5IF	OPC
RANBP1	OPC
RANGAP1	OPC
RARB	OPC
RASGRF1	OPC
RBCK1	OPC
RBX1	OPC
RCE1	OPC
RDH14	OPC
REEP2	OPC
RELA	OPC
RETREG2	OPC
REX1BD	OPC
REXO2	OPC
RHEB	OPC
RHOB	OPC
RMDN2	OPC
RNF6	OPC
RNFT2	OPC
RNPS1	OPC
ROCK1	OPC
RPF2	OPC
RPGRIP1	OPC
RPL10A	OPC
RPL13	OPC
RPL22	OPC
RPL37	OPC
RPL6	OPC
RRP7A	OPC
RTCB	OPC
RTF1	OPC
RTN4	OPC
SAR1A	OPC
SARS1	OPC
SCG3	OPC
SCG5	OPC
SDE2	OPC
SDF4	OPC
SDHD	OPC
SEC22C	OPC
SEC61G	OPC
SELENOF	OPC
SELENOS	OPC
SEM1	OPC
SERBP1	OPC
SETSIP	OPC
SF3B2	OPC
SFR1	OPC
SGTB	OPC
SKA3	OPC
SKIL	OPC
SLAIN2	OPC
SLC1A2	OPC
SLC25A11	OPC
SLC25A3	OPC
SLC39A10	OPC
SLC6A15	OPC
SLC7A10	OPC
SLC8A1	OPC
SMAP2	OPC
SMIM11B	OPC
SMIM11A	OPC
SMIM12	OPC
SMIM13	OPC
SMIM14	OPC
SMIM7	OPC
SNAP25	OPC
SNAP47	OPC
SNRPC	OPC
SNRPE	OPC
SOX12	OPC
SPOCK3	OPC
SPRYD3	OPC
SPTBN4	OPC
SRCIN1	OPC
SRD5A3	OPC
SRP14	OPC
SRP9	OPC
SRPK1	OPC
SRPRA	OPC
SSB	OPC
SSBP3	OPC
SSBP4	OPC
SSX2IP	OPC
ST3GAL5	OPC
STIP1	OPC
STK16	OPC
STMN1	OPC
STMN4	OPC
STRAP	OPC
STRN	OPC
STUB1	OPC
SUCLA2	OPC
SUCLG1	OPC
SUPT4H1	OPC
SWI5	OPC
SYCP2	OPC
SYNGR3	OPC
TALDO1	OPC
TBCA	OPC
TBCC	OPC
TCEAL6	OPC
TCEAL5	OPC
TCEAL3	OPC
TCEAL8	OPC
TCF25	OPC
TCP1	OPC
TENM4	OPC
TESK1	OPC
THYN1	OPC
TIMM13	OPC
TIMM50	OPC
TM9SF2	OPC
TM9SF3	OPC
TMBIM4	OPC
TMED4	OPC
TMEM101	OPC
TMEM176B	OPC
TMEM18	OPC
TMEM25	OPC
TMEM256	OPC
TMEM256-PLSCR3	OPC
TMEM33	OPC
TMEM47	OPC
TMEM59	OPC
TMSB4Y	OPC
TMTC1	OPC
TOLLIP	OPC
TOMM34	OPC
TOR1A	OPC
TPRG1L	OPC
TRIB2	OPC
TRMT2B	OPC
TRPM3	OPC
TSNAXIP1	OPC
TSPOAP1	OPC
TTC3	OPC
TTLL7	OPC
TUBG1	OPC
TWSG1	OPC
TXNL1	OPC
TXNRD1	OPC
UBE2V2	OPC
UBE2Z	OPC
UBTF	OPC
UBXN1	OPC
UBXN6	OPC
UNC13C	OPC
UPF1	OPC
UQCRC1	OPC
USP14	OPC
USP2	OPC
VCP	OPC
VPS29	OPC
VPS4A	OPC
WASF1	OPC
WBP4	OPC
WDR11	OPC
WDR18	OPC
WSB2	OPC
YLPM1	OPC
YPEL2	OPC
YPEL3	OPC
YWHAE	OPC
YWHAG	OPC
YWHAQ	OPC
YWHAZ	OPC
ZBTB7A	OPC
ZC3H15	OPC
ZCRB1	OPC
ZFAND5	OPC
ZNF239	OPC
ZNF385B	OPC
ZNF445	OPC
