Gene	cell_type
KIAA0825	Astrocytes
C6orf136	Astrocytes
AAMP	Astrocytes
AATK	Astrocytes
ABCA3	Astrocytes
ABCC5	Astrocytes
ABCD2	Astrocytes
ABCG4	Astrocytes
ABHD16A	Astrocytes
ACOT7	Astrocytes
ACTR1B	Astrocytes
ADAM23	Astrocytes
ADAMTSL5	Astrocytes
ADCY8	Astrocytes
ADGRB1	Astrocytes
ADGRB2	Astrocytes
ADGRB3	Astrocytes
ADH5	Astrocytes
AHSA1	Astrocytes
AKAP11	Astrocytes
ALCAM	Astrocytes
ALK	Astrocytes
ANGPT1	Astrocytes
AP1S2	Astrocytes
AP3B2	Astrocytes
APBB2	Astrocytes
APLP2	Astrocytes
APOE	Astrocytes
ARHGAP32	Astrocytes
ARHGAP42	Astrocytes
ARHGEF7	Astrocytes
ARMC8	Astrocytes
ARMCX5	Astrocytes
ARPC4	Astrocytes
ARRDC3	Astrocytes
SPCS3	Astrocytes
ASIC2	Astrocytes
ASPA	Astrocytes
ASTN2	Astrocytes
ATP13A4	Astrocytes
ATP2A2	Astrocytes
ATP2B4	Astrocytes
ATP6V1G2-DDX39B	Astrocytes
ATXN7L3B	Astrocytes
B3GALT2	Astrocytes
BAG4	Astrocytes
BCAN	Astrocytes
BCR	Astrocytes
BLCAP	Astrocytes
BMPER	Astrocytes
BNIP3L	Astrocytes
BOLA3	Astrocytes
BRINP3	Astrocytes
BRSK2	Astrocytes
BUB3	Astrocytes
BZW1	Astrocytes
CACNA2D2	Astrocytes
CACNB2	Astrocytes
CADPS2	Astrocytes
CAMSAP1	Astrocytes
CAPNS1	Astrocytes
CAPZA2	Astrocytes
CA8	Astrocytes
CBR1	Astrocytes
CCDC25	Astrocytes
CCDC47	Astrocytes
CCDC85A	Astrocytes
CCSER1	Astrocytes
CCT4	Astrocytes
CDH13	Astrocytes
CDH2	Astrocytes
CDH22	Astrocytes
CDK17	Astrocytes
CDK5	Astrocytes
CDK9	Astrocytes
CEBPZOS	Astrocytes
CEP126	Astrocytes
CFLAR	Astrocytes
CHL1	Astrocytes
CIT	Astrocytes
CLCN4	Astrocytes
CLIP3	Astrocytes
CLYBL	Astrocytes
CMSS1	Astrocytes
CNPY2	Astrocytes
CNTFR	Astrocytes
CNTN1	Astrocytes
COL11A1	Astrocytes
COLEC12	Astrocytes
COMMD4	Astrocytes
COPB2	Astrocytes
COQ7	Astrocytes
COX8A	Astrocytes
CRLF3	Astrocytes
CRYM	Astrocytes
CSMD1	Astrocytes
CTHRC1	Astrocytes
CTNNB1	Astrocytes
CTSB	Astrocytes
CTTNBP2	Astrocytes
KIAA1549	Astrocytes
DAB1	Astrocytes
DACH1	Astrocytes
DAPK1	Astrocytes
DCLK1	Astrocytes
DCUN1D4	Astrocytes
DDA1	Astrocytes
DDIT3	Astrocytes
DDX10	Astrocytes
DEGS1	Astrocytes
DEK	Astrocytes
DENR	Astrocytes
DGKI	Astrocytes
DHCR24	Astrocytes
DKK3	Astrocytes
DLD	Astrocytes
DLGAP1	Astrocytes
DNAJC16	Astrocytes
DOCK3	Astrocytes
DOCK4	Astrocytes
DOK6	Astrocytes
DPYD	Astrocytes
DPYSL2	Astrocytes
DRP2	Astrocytes
DTD1	Astrocytes
DZIP1L	Astrocytes
EDF1	Astrocytes
EEF1A1	Astrocytes
EEF1D	Astrocytes
EEF1G	Astrocytes
EGLN2	Astrocytes
EHMT2	Astrocytes
EID1	Astrocytes
EIF1	Astrocytes
EIF1B	Astrocytes
EIF3M	Astrocytes
ELOC	Astrocytes
ELP1	Astrocytes
EMSY	Astrocytes
ENAH	Astrocytes
ENOX1	Astrocytes
EPHA4	Astrocytes
EPHA5	Astrocytes
EPHB1	Astrocytes
EPN1	Astrocytes
EPS8	Astrocytes
ERBB4	Astrocytes
ERGIC1	Astrocytes
ESRRG	Astrocytes
ESYT2	Astrocytes
EWSR1	Astrocytes
EXD2	Astrocytes
FAM107A	Astrocytes
FAM120C	Astrocytes
FAM131A	Astrocytes
FBXO34	Astrocytes
FBXO45	Astrocytes
FDFT1	Astrocytes
FGF14	Astrocytes
FGFR1	Astrocytes
FIS1	Astrocytes
FMNL2	Astrocytes
FOLH1	Astrocytes
FOXG1	Astrocytes
FOXP1	Astrocytes
FREM2	Astrocytes
FRY	Astrocytes
FTL	Astrocytes
FUT9	Astrocytes
GAB1	Astrocytes
GABBR2	Astrocytes
GABRA4	Astrocytes
GADD45G	Astrocytes
GALNT18	Astrocytes
GAS6	Astrocytes
GDPD1	Astrocytes
GHR	Astrocytes
GLS	Astrocytes
GLUD2	Astrocytes
GLUD1	Astrocytes
GLUL	Astrocytes
KLRB1	Astrocytes
NUP58	Astrocytes
GMFB	Astrocytes
GPC5	Astrocytes
GPCPD1	Astrocytes
GPM6A	Astrocytes
GPR137C	Astrocytes
GPR37L1	Astrocytes
GPRASP1	Astrocytes
GPSM1	Astrocytes
GRIA1	Astrocytes
GRIA2	Astrocytes
GRIK2	Astrocytes
GRIN2C	Astrocytes
GRINA	Astrocytes
GSDME	Astrocytes
H3-3A	Astrocytes
HAGH	Astrocytes
HDGF	Astrocytes
HEATR5B	Astrocytes
HERC6	Astrocytes
HGF	Astrocytes
HIBCH	Astrocytes
HIGD1A	Astrocytes
HINT2	Astrocytes
HIVEP3	Astrocytes
HMGCR	Astrocytes
HNRNPA1	Astrocytes
HNRNPA2B1	Astrocytes
HNRNPK	Astrocytes
HNRNPU	Astrocytes
HRH1	Astrocytes
HS3ST3A1	Astrocytes
HSBP1	Astrocytes
HTRA2	Astrocytes
HUNK	Astrocytes
HYPK	Astrocytes
IDH3A	Astrocytes
IDH3B	Astrocytes
IDH3G	Astrocytes
IFT22	Astrocytes
IGSF11	Astrocytes
IKZF2	Astrocytes
IL1RAPL1	Astrocytes
IMPA1	Astrocytes
INF2	Astrocytes
INHBA	Astrocytes
IQGAP1	Astrocytes
ISCA1	Astrocytes
ITGB1BP1	Astrocytes
ITPA	Astrocytes
ITPR1	Astrocytes
JADE1	Astrocytes
JAZF1	Astrocytes
JOSD2	Astrocytes
KANK1	Astrocytes
KANSL1L	Astrocytes
KCND2	Astrocytes
KCND3	Astrocytes
KCNH5	Astrocytes
KCNN2	Astrocytes
KCNQ3	Astrocytes
KDELR1	Astrocytes
KEAP1	Astrocytes
KHDRBS3	Astrocytes
KIF21A	Astrocytes
KIF3A	Astrocytes
KLC1	Astrocytes
KLHDC9	Astrocytes
KLHL26	Astrocytes
KLHL9	Astrocytes
KMT5A	Astrocytes
KPNA6	Astrocytes
KPNB1	Astrocytes
KRT10	Astrocytes
LAMTOR3	Astrocytes
LDLR	Astrocytes
LHCGR	Astrocytes
LMBRD2	Astrocytes
LONP1	Astrocytes
LRIG1	Astrocytes
LRMDA	Astrocytes
LRP1B	Astrocytes
LRP5	Astrocytes
LRPPRC	Astrocytes
LRRC45	Astrocytes
LRRC8C	Astrocytes
LRTM2	Astrocytes
LSAMP	Astrocytes
LSM7	Astrocytes
LSM8	Astrocytes
LUZP2	Astrocytes
MAN2A1	Astrocytes
MAP2K1	Astrocytes
MAP2K5	Astrocytes
MAPK8IP1	Astrocytes
MBOAT7	Astrocytes
MCRS1	Astrocytes
ME3	Astrocytes
MED19	Astrocytes
MEF2C	Astrocytes
MEN1	Astrocytes
MFGE8	Astrocytes
MFN1	Astrocytes
MFN2	Astrocytes
MGAT4C	Astrocytes
MGAT5	Astrocytes
MGLL	Astrocytes
MIB2	Astrocytes
MIPOL1	Astrocytes
MLX	Astrocytes
MORF4L2	Astrocytes
MPHOSPH8	Astrocytes
MRPL2	Astrocytes
MRPL32	Astrocytes
MRPL34	Astrocytes
MRPL55	Astrocytes
MRPS12	Astrocytes
MRPS21	Astrocytes
MRPS33	Astrocytes
MSL3	Astrocytes
MSMO1	Astrocytes
MT1G	Astrocytes
MTLN	Astrocytes
MTMR6	Astrocytes
MTX1	Astrocytes
MYEF2	Astrocytes
MYH14	Astrocytes
N4BP1	Astrocytes
NALCN	Astrocytes
NAP1L5	Astrocytes
NAV3	Astrocytes
NCAN	Astrocytes
NCL	Astrocytes
NDST1	Astrocytes
NDUFA6	Astrocytes
NDUFC2-KCTD14	Astrocytes
NDUFC2	Astrocytes
NDUFV3	Astrocytes
NEU1	Astrocytes
NGEF	Astrocytes
NHSL1	Astrocytes
NKAIN2	Astrocytes
NOL11	Astrocytes
NPAS2	Astrocytes
NPDC1	Astrocytes
NPTN	Astrocytes
NRCAM	Astrocytes
NRG1	Astrocytes
NRP1	Astrocytes
NSMF	Astrocytes
NTRK3	Astrocytes
ODC1	Astrocytes
OST4	Astrocytes
OTX1	Astrocytes
P2RX4	Astrocytes
PACSIN2	Astrocytes
PAK1	Astrocytes
PAK1IP1	Astrocytes
PANK4	Astrocytes
PAX6	Astrocytes
PCBP4	Astrocytes
PCDH11Y	Astrocytes
PCDH11X	Astrocytes
PCDH19	Astrocytes
PDE10A	Astrocytes
PDE1C	Astrocytes
PDE7B	Astrocytes
PDZD2	Astrocytes
PFDN4	Astrocytes
PFDN6	Astrocytes
PGAP1	Astrocytes
PHC3	Astrocytes
PHKA1	Astrocytes
PIK3IP1	Astrocytes
PINK1	Astrocytes
PIP4K2B	Astrocytes
PIP4K2C	Astrocytes
PIR	Astrocytes
PJA2	Astrocytes
PKIG	Astrocytes
PKP4	Astrocytes
PLA2G7	Astrocytes
PLCB1	Astrocytes
PLCE1	Astrocytes
PLEC	Astrocytes
PLEKHA5	Astrocytes
PLEKHJ1	Astrocytes
PLOD3	Astrocytes
PLS1	Astrocytes
PMPCB	Astrocytes
PNPLA7	Astrocytes
POLR2K	Astrocytes
POM121C	Astrocytes
POM121	Astrocytes
POR	Astrocytes
PPDPF	Astrocytes
PPID	Astrocytes
PPM1L	Astrocytes
PPP1R11	Astrocytes
PPP1R9A	Astrocytes
PPP2CA	Astrocytes
PPP2R2B	Astrocytes
PPT2-EGFL8	Astrocytes
PPT2	Astrocytes
PRDM16	Astrocytes
PRDX6	Astrocytes
PREX2	Astrocytes
PRICKLE1	Astrocytes
PRKACA	Astrocytes
PRKAG2	Astrocytes
PRKCE	Astrocytes
PRPF4B	Astrocytes
PRRC2B	Astrocytes
PRRX1	Astrocytes
PSAP	Astrocytes
PSD2	Astrocytes
PSENEN	Astrocytes
PSIP1	Astrocytes
PSMA1	Astrocytes
PSMA2	Astrocytes
PSMB1	Astrocytes
PSMB7	Astrocytes
PSMD4	Astrocytes
PSMD6	Astrocytes
PSMD8	Astrocytes
PTPN11	Astrocytes
PTPRJ	Astrocytes
PTPRN2	Astrocytes
PTPRS	Astrocytes
PURB	Astrocytes
QARS1	Astrocytes
RAB3IP	Astrocytes
RABGGTA	Astrocytes
RALYL	Astrocytes
RANBP6	Astrocytes
RARB	Astrocytes
RBCK1	Astrocytes
RBMXL1	Astrocytes
RBX1	Astrocytes
RC3H2	Astrocytes
RDH14	Astrocytes
REEP5	Astrocytes
RETREG3	Astrocytes
RFX1	Astrocytes
RGS3	Astrocytes
RNF126	Astrocytes
RNF149	Astrocytes
RNF215	Astrocytes
RNF220	Astrocytes
ROBO2	Astrocytes
ROCK2	Astrocytes
RORA	Astrocytes
RPA3	Astrocytes
RPGRIP1	Astrocytes
RPL22L1	Astrocytes
RPL34	Astrocytes
RPL6	Astrocytes
RPS19BP1	Astrocytes
RPS21	Astrocytes
RPS29	Astrocytes
RSPO3	Astrocytes
RSRP1	Astrocytes
SAMD4A	Astrocytes
SAMD8	Astrocytes
SAMM50	Astrocytes
SARAF	Astrocytes
SARS1	Astrocytes
SBF1	Astrocytes
SCARA3	Astrocytes
SCD	Astrocytes
SCN8A	Astrocytes
SDF4	Astrocytes
SDHB	Astrocytes
SDHD	Astrocytes
SEC14L1	Astrocytes
SEC62	Astrocytes
SERBP1	Astrocytes
SESN1	Astrocytes
SESN3	Astrocytes
SETD7	Astrocytes
SF3B2	Astrocytes
SFR1	Astrocytes
SGCD	Astrocytes
SGIP1	Astrocytes
SGTB	Astrocytes
SHISA4	Astrocytes
SHROOM2	Astrocytes
SHROOM3	Astrocytes
SIK2	Astrocytes
SIX3	Astrocytes
SLC10A7	Astrocytes
SLC22A23	Astrocytes
SLC25A18	Astrocytes
SLC25A25	Astrocytes
SLC25A3	Astrocytes
SLC25A44	Astrocytes
SLC35C2	Astrocytes
SLC35F1	Astrocytes
SLC36A1	Astrocytes
SLC38A3	Astrocytes
SLC39A12	Astrocytes
SLC43A2	Astrocytes
SLC50A1	Astrocytes
SLC9A6	Astrocytes
SMIM4	Astrocytes
SMPD1	Astrocytes
SMPD4	Astrocytes
SNRPC	Astrocytes
SNRPE	Astrocytes
SNRPF	Astrocytes
SNTB1	Astrocytes
SNX12	Astrocytes
SORBS2	Astrocytes
SORCS2	Astrocytes
SOX9	Astrocytes
SPG21	Astrocytes
SPON1	Astrocytes
SPRYD7	Astrocytes
SPTAN1	Astrocytes
SRA1	Astrocytes
SRPRA	Astrocytes
SRSF11	Astrocytes
SRSF3	Astrocytes
SSH2	Astrocytes
SSR4	Astrocytes
ST6GALNAC6	Astrocytes
STARD3NL	Astrocytes
STK17B	Astrocytes
STK3	Astrocytes
STRN	Astrocytes
STRN4	Astrocytes
STX16-NPEPL1	Astrocytes
STX16	Astrocytes
STX1A	Astrocytes
SUGT1	Astrocytes
SUPT4H1	Astrocytes
SYBU	Astrocytes
TADA3	Astrocytes
TAF1D	Astrocytes
TBC1D10B	Astrocytes
TBC1D17	Astrocytes
TBRG1	Astrocytes
TCAF1	Astrocytes
TCF12	Astrocytes
TECR	Astrocytes
TERF2IP	Astrocytes
TEX264	Astrocytes
THBS4	Astrocytes
THRA	Astrocytes
THSD4	Astrocytes
THSD7A	Astrocytes
TIMM9	Astrocytes
TIPARP	Astrocytes
TMCC2	Astrocytes
TMEFF1	Astrocytes
TMEM38A	Astrocytes
TMEM59	Astrocytes
TNFAIP8	Astrocytes
TRAPPC4	Astrocytes
TRIM2	Astrocytes
TRIM9	Astrocytes
TRMT10C	Astrocytes
TP53BP2	Astrocytes
TRPM3	Astrocytes
TSC22D1	Astrocytes
TSFM	Astrocytes
TSHZ2	Astrocytes
TSN	Astrocytes
TSNAX-DISC1	Astrocytes
TSPAN7	Astrocytes
TSR3	Astrocytes
TTC3	Astrocytes
TTC33	Astrocytes
TXNRD1	Astrocytes
UBC	Astrocytes
UBE2A	Astrocytes
UBE2E2	Astrocytes
UBE2G1	Astrocytes
UBE2H	Astrocytes
UBE2Z	Astrocytes
UBE3A	Astrocytes
UCHL3	Astrocytes
UFC1	Astrocytes
UNC5C	Astrocytes
UNC79	Astrocytes
UPF1	Astrocytes
USE1	Astrocytes
USP11	Astrocytes
USP14	Astrocytes
USP5	Astrocytes
VAMP2	Astrocytes
VCP	Astrocytes
VDAC2	Astrocytes
VKORC1	Astrocytes
VMP1	Astrocytes
WBP4	Astrocytes
WDR17	Astrocytes
WDR6	Astrocytes
WDR61	Astrocytes
WDR74	Astrocytes
XPR1	Astrocytes
YME1L1	Astrocytes
YPEL3	Astrocytes
YWHAQ	Astrocytes
ZBTB7A	Astrocytes
ZC3H15	Astrocytes
ZCRB1	Astrocytes
ZER1	Astrocytes
ZNHIT1	Astrocytes
ZNRF1	Astrocytes
ZSWIM5	Astrocytes
ACTG1	Endothelial
ALCAM	Endothelial
ANK2	Endothelial
CENPP	Endothelial
COG7	Endothelial
HSP90AB1	Endothelial
IQSEC1	Endothelial
NAPG	Endothelial
NDUFA7	Endothelial
PTGDS	Endothelial
RPS19	Endothelial
TSPAN7	Endothelial
ZFPM2	Endothelial
PPP1R2	Interneurons_Chat+
PPP1R2B	Interneurons_Chat+
NCBP2AS2	Interneurons_Pnoc+
AAMP	Interneurons_Pnoc+
ABHD8	Interneurons_Pnoc+
ADARB2	Interneurons_Pnoc+
ADCY5	Interneurons_Pnoc+
C11orf87	Interneurons_Pnoc+
AMMECR1	Interneurons_Pnoc+
ANKRD13B	Interneurons_Pnoc+
ARF3	Interneurons_Pnoc+
ARF5	Interneurons_Pnoc+
ARHGDIA	Interneurons_Pnoc+
ARPC1A	Interneurons_Pnoc+
ARPP19	Interneurons_Pnoc+
ASPHD2	Interneurons_Pnoc+
ATP5F1A	Interneurons_Pnoc+
ATP5F1B	Interneurons_Pnoc+
ATP5MF	Interneurons_Pnoc+
ATP6V1E1	Interneurons_Pnoc+
ATP6V1F	Interneurons_Pnoc+
ATP6V1G1	Interneurons_Pnoc+
ATP9B	Interneurons_Pnoc+
ATXN2L	Interneurons_Pnoc+
ATXN7L3B	Interneurons_Pnoc+
BAIAP2	Interneurons_Pnoc+
BAIAP3	Interneurons_Pnoc+
BEX2	Interneurons_Pnoc+
BEX1	Interneurons_Pnoc+
BRI3	Interneurons_Pnoc+
BTF3	Interneurons_Pnoc+
CALB1	Interneurons_Pnoc+
CALM1	Interneurons_Pnoc+
CALM2	Interneurons_Pnoc+
CAPZA2	Interneurons_Pnoc+
CA11	Interneurons_Pnoc+
CARTPT	Interneurons_Pnoc+
CCNL2	Interneurons_Pnoc+
CCSER1	Interneurons_Pnoc+
CCT8	Interneurons_Pnoc+
CDH8	Interneurons_Pnoc+
CELF3	Interneurons_Pnoc+
CHST1	Interneurons_Pnoc+
CHSY3	Interneurons_Pnoc+
CKB	Interneurons_Pnoc+
CLIC4	Interneurons_Pnoc+
CMSS1	Interneurons_Pnoc+
CNTN4	Interneurons_Pnoc+
COX14	Interneurons_Pnoc+
COX6C	Interneurons_Pnoc+
COX7C	Interneurons_Pnoc+
COX8A	Interneurons_Pnoc+
CPLX2	Interneurons_Pnoc+
CPNE5	Interneurons_Pnoc+
CREG2	Interneurons_Pnoc+
CSDE1	Interneurons_Pnoc+
CTNNA3	Interneurons_Pnoc+
CTTNBP2	Interneurons_Pnoc+
CYC1	Interneurons_Pnoc+
DCC	Interneurons_Pnoc+
DDX3Y	Interneurons_Pnoc+
DESI2	Interneurons_Pnoc+
DPM3	Interneurons_Pnoc+
DTX3	Interneurons_Pnoc+
DYNLL1	Interneurons_Pnoc+
DYNLL2	Interneurons_Pnoc+
ECEL1	Interneurons_Pnoc+
EEF1A1	Interneurons_Pnoc+
EEF2	Interneurons_Pnoc+
EID2	Interneurons_Pnoc+
EIF3CL	Interneurons_Pnoc+
EIF3C	Interneurons_Pnoc+
EIF3K	Interneurons_Pnoc+
EIF5AL1	Interneurons_Pnoc+
EIF5A	Interneurons_Pnoc+
EMC6	Interneurons_Pnoc+
ESD	Interneurons_Pnoc+
ETS2	Interneurons_Pnoc+
EWSR1	Interneurons_Pnoc+
FAM174A	Interneurons_Pnoc+
FBXL16	Interneurons_Pnoc+
FGD5	Interneurons_Pnoc+
FKBP1A	Interneurons_Pnoc+
FKBP1C	Interneurons_Pnoc+
FKBP8	Interneurons_Pnoc+
FOXP2	Interneurons_Pnoc+
FUS	Interneurons_Pnoc+
GABRB2	Interneurons_Pnoc+
C4orf48	Interneurons_Pnoc+
GNB2	Interneurons_Pnoc+
GPR45	Interneurons_Pnoc+
GRIA3	Interneurons_Pnoc+
GRIK2	Interneurons_Pnoc+
GRINA	Interneurons_Pnoc+
GRM7	Interneurons_Pnoc+
H3-3A	Interneurons_Pnoc+
H3-5	Interneurons_Pnoc+
H3-3B	Interneurons_Pnoc+
HAP1	Interneurons_Pnoc+
HINT1	Interneurons_Pnoc+
HNRNPA0	Interneurons_Pnoc+
HNRNPA2B1	Interneurons_Pnoc+
HSP90AB1	Interneurons_Pnoc+
HSPE1	Interneurons_Pnoc+
HTR2C	Interneurons_Pnoc+
IGSF21	Interneurons_Pnoc+
INPP4B	Interneurons_Pnoc+
KALRN	Interneurons_Pnoc+
KCNH7	Interneurons_Pnoc+
KCNIP2	Interneurons_Pnoc+
KCNK1	Interneurons_Pnoc+
KCTD16	Interneurons_Pnoc+
KDM5D	Interneurons_Pnoc+
KHDRBS2	Interneurons_Pnoc+
KLHL1	Interneurons_Pnoc+
KMT2C	Interneurons_Pnoc+
LDHB	Interneurons_Pnoc+
LHFPL3	Interneurons_Pnoc+
LLPH	Interneurons_Pnoc+
LRRC73	Interneurons_Pnoc+
LRRTM4	Interneurons_Pnoc+
LY6H	Interneurons_Pnoc+
LZTS3	Interneurons_Pnoc+
MAGED1	Interneurons_Pnoc+
MAGI3	Interneurons_Pnoc+
MARCKS	Interneurons_Pnoc+
MBP	Interneurons_Pnoc+
MCFD2	Interneurons_Pnoc+
MDH1	Interneurons_Pnoc+
MDH2	Interneurons_Pnoc+
MED28	Interneurons_Pnoc+
MGAT4C	Interneurons_Pnoc+
MRPL20	Interneurons_Pnoc+
MSMO1	Interneurons_Pnoc+
MSRB2	Interneurons_Pnoc+
MYL6	Interneurons_Pnoc+
MYO5B	Interneurons_Pnoc+
NAP1L1	Interneurons_Pnoc+
NCOA5	Interneurons_Pnoc+
NDRG4	Interneurons_Pnoc+
NDST4	Interneurons_Pnoc+
NDUFA11	Interneurons_Pnoc+
NDUFA5	Interneurons_Pnoc+
NDUFA9	Interneurons_Pnoc+
NDUFAF3	Interneurons_Pnoc+
NDUFB2	Interneurons_Pnoc+
NDUFS2	Interneurons_Pnoc+
NFE2L3	Interneurons_Pnoc+
NGEF	Interneurons_Pnoc+
NKAIN2	Interneurons_Pnoc+
NWD2	Interneurons_Pnoc+
OAZ1	Interneurons_Pnoc+
OPCML	Interneurons_Pnoc+
PAM16	Interneurons_Pnoc+
PARK7	Interneurons_Pnoc+
PBX3	Interneurons_Pnoc+
PCDH10	Interneurons_Pnoc+
PCDH15	Interneurons_Pnoc+
PDCD6	Interneurons_Pnoc+
PDE1B	Interneurons_Pnoc+
PDE4D	Interneurons_Pnoc+
PDIA3	Interneurons_Pnoc+
PFDN2	Interneurons_Pnoc+
PGRMC1	Interneurons_Pnoc+
PIN1	Interneurons_Pnoc+
PKM	Interneurons_Pnoc+
PLCL1	Interneurons_Pnoc+
PLK2	Interneurons_Pnoc+
PNMA8B	Interneurons_Pnoc+
POLB	Interneurons_Pnoc+
POM121C	Interneurons_Pnoc+
POM121	Interneurons_Pnoc+
PPP3R1	Interneurons_Pnoc+
PRDM16	Interneurons_Pnoc+
PRDX1	Interneurons_Pnoc+
PRDX5	Interneurons_Pnoc+
PRKD1	Interneurons_Pnoc+
PRPF4B	Interneurons_Pnoc+
PRRG3	Interneurons_Pnoc+
PSENEN	Interneurons_Pnoc+
PSMA7	Interneurons_Pnoc+
PSMB3	Interneurons_Pnoc+
PTPN3	Interneurons_Pnoc+
RAB40B	Interneurons_Pnoc+
RACK1	Interneurons_Pnoc+
RARB	Interneurons_Pnoc+
RASL10B	Interneurons_Pnoc+
RFTN1	Interneurons_Pnoc+
RGS9	Interneurons_Pnoc+
RNPC3	Interneurons_Pnoc+
ROBO1	Interneurons_Pnoc+
RPL10A	Interneurons_Pnoc+
RPL13	Interneurons_Pnoc+
RPL22L1	Interneurons_Pnoc+
RPN1	Interneurons_Pnoc+
RPS15	Interneurons_Pnoc+
RPS2	Interneurons_Pnoc+
RRAGD	Interneurons_Pnoc+
RRP1	Interneurons_Pnoc+
RTN1	Interneurons_Pnoc+
RUNX1T1	Interneurons_Pnoc+
SCAND1	Interneurons_Pnoc+
SCG2	Interneurons_Pnoc+
SCMH1	Interneurons_Pnoc+
SDHAF4	Interneurons_Pnoc+
SF3B5	Interneurons_Pnoc+
SF3B6	Interneurons_Pnoc+
SGCZ	Interneurons_Pnoc+
SLC4A4	Interneurons_Pnoc+
SLC9A7	Interneurons_Pnoc+
SLIT3	Interneurons_Pnoc+
SORCS3	Interneurons_Pnoc+
SOX5	Interneurons_Pnoc+
SRRM2	Interneurons_Pnoc+
ST8SIA3	Interneurons_Pnoc+
SYT11	Interneurons_Pnoc+
TAF1D	Interneurons_Pnoc+
TAGLN3	Interneurons_Pnoc+
TENM1	Interneurons_Pnoc+
TIMM8B	Interneurons_Pnoc+
TMA7	Interneurons_Pnoc+
TMCC3	Interneurons_Pnoc+
TMEFF2	Interneurons_Pnoc+
TMEM108	Interneurons_Pnoc+
TMEM163	Interneurons_Pnoc+
TMSB4Y	Interneurons_Pnoc+
TOMM70	Interneurons_Pnoc+
TRIQK	Interneurons_Pnoc+
TRPC4	Interneurons_Pnoc+
TSPYL5	Interneurons_Pnoc+
TUBA1B	Interneurons_Pnoc+
UBB	Interneurons_Pnoc+
UBTF	Interneurons_Pnoc+
UNC5D	Interneurons_Pnoc+
UQCRH	Interneurons_Pnoc+
UQCRHL	Interneurons_Pnoc+
UQCRQ	Interneurons_Pnoc+
UTY	Interneurons_Pnoc+
VAMP2	Interneurons_Pnoc+
VDAC2	Interneurons_Pnoc+
WDR83OS	Interneurons_Pnoc+
XRCC6	Interneurons_Pnoc+
YWHAB	Interneurons_Pnoc+
ZEB2	Interneurons_Pnoc+
ZFHX3	Interneurons_Pnoc+
ZNF365	Interneurons_Pnoc+
ZNF423	Interneurons_Pnoc+
ZIC1	Interneurons_Pnoc+
ZMIZ1	Interneurons_Pnoc+
ZMYND11	Interneurons_Pnoc+
C1orf21	Interneurons_Pvalb+
CXorf38	Interneurons_Pvalb+
AAK1	Interneurons_Pvalb+
AATF	Interneurons_Pvalb+
ABCA2	Interneurons_Pvalb+
ABCB5	Interneurons_Pvalb+
ABHD18	Interneurons_Pvalb+
ACP6	Interneurons_Pvalb+
ACTB	Interneurons_Pvalb+
ACTR2	Interneurons_Pvalb+
ACTR3B	Interneurons_Pvalb+
ACTR3C	Interneurons_Pvalb+
ACVR1	Interneurons_Pvalb+
ADAM10	Interneurons_Pvalb+
ADAM15	Interneurons_Pvalb+
ADAM17	Interneurons_Pvalb+
ADAM23	Interneurons_Pvalb+
ADAMTS17	Interneurons_Pvalb+
ADARB2	Interneurons_Pvalb+
ADCY1	Interneurons_Pvalb+
ADCY8	Interneurons_Pvalb+
ADD3	Interneurons_Pvalb+
ADGRL3	Interneurons_Pvalb+
ADK	Interneurons_Pvalb+
ADRA1A	Interneurons_Pvalb+
AFF2	Interneurons_Pvalb+
AGBL4	Interneurons_Pvalb+
AIFM1	Interneurons_Pvalb+
AIG1	Interneurons_Pvalb+
AKAIN1	Interneurons_Pvalb+
AKAP11	Interneurons_Pvalb+
ALK	Interneurons_Pvalb+
ANK1	Interneurons_Pvalb+
ANKFY1	Interneurons_Pvalb+
ANKRD12	Interneurons_Pvalb+
ANO4	Interneurons_Pvalb+
AP1B1	Interneurons_Pvalb+
AP2A2	Interneurons_Pvalb+
AP4M1	Interneurons_Pvalb+
APAF1	Interneurons_Pvalb+
APC	Interneurons_Pvalb+
ARF3	Interneurons_Pvalb+
ARHGAP10	Interneurons_Pvalb+
ARHGAP17	Interneurons_Pvalb+
ARHGAP18	Interneurons_Pvalb+
ARHGAP32	Interneurons_Pvalb+
ARHGEF10L	Interneurons_Pvalb+
ARHGEF2	Interneurons_Pvalb+
ARHGEF9	Interneurons_Pvalb+
ARID1A	Interneurons_Pvalb+
ARID1B	Interneurons_Pvalb+
ARID4B	Interneurons_Pvalb+
ARID5B	Interneurons_Pvalb+
ARL15	Interneurons_Pvalb+
ARL2BP	Interneurons_Pvalb+
ARRB1	Interneurons_Pvalb+
ASAH1	Interneurons_Pvalb+
ATE1	Interneurons_Pvalb+
ATF6	Interneurons_Pvalb+
ATF7IP	Interneurons_Pvalb+
ATM	Interneurons_Pvalb+
ATP13A3	Interneurons_Pvalb+
ATP2A2	Interneurons_Pvalb+
ATP2C1	Interneurons_Pvalb+
ATP5F1B	Interneurons_Pvalb+
ATP5ME	Interneurons_Pvalb+
ATP5PO	Interneurons_Pvalb+
DONSON	Interneurons_Pvalb+
ATP6AP2	Interneurons_Pvalb+
ATP6V0B	Interneurons_Pvalb+
ATP6V0C	Interneurons_Pvalb+
ATP6V0E1	Interneurons_Pvalb+
ATP6V1E1	Interneurons_Pvalb+
ATP6V1F	Interneurons_Pvalb+
ATRNL1	Interneurons_Pvalb+
B4GALT6	Interneurons_Pvalb+
BAG1	Interneurons_Pvalb+
BAG4	Interneurons_Pvalb+
BANF1	Interneurons_Pvalb+
BAZ2B	Interneurons_Pvalb+
BCAP29	Interneurons_Pvalb+
BCKDHB	Interneurons_Pvalb+
BEX2	Interneurons_Pvalb+
BEX1	Interneurons_Pvalb+
BFAR	Interneurons_Pvalb+
BHLHE41	Interneurons_Pvalb+
BICDL1	Interneurons_Pvalb+
BRINP1	Interneurons_Pvalb+
BRINP2	Interneurons_Pvalb+
BRINP3	Interneurons_Pvalb+
BRSK2	Interneurons_Pvalb+
BTAF1	Interneurons_Pvalb+
BTBD11	Interneurons_Pvalb+
BTBD3	Interneurons_Pvalb+
BTG3	Interneurons_Pvalb+
CABIN1	Interneurons_Pvalb+
CABP1	Interneurons_Pvalb+
CACNA1A	Interneurons_Pvalb+
CACNA2D1	Interneurons_Pvalb+
CACNB2	Interneurons_Pvalb+
CADM1	Interneurons_Pvalb+
CALB1	Interneurons_Pvalb+
CALM2	Interneurons_Pvalb+
CALY	Interneurons_Pvalb+
CAMK2B	Interneurons_Pvalb+
CAMK4	Interneurons_Pvalb+
CAP2	Interneurons_Pvalb+
CAPZA2	Interneurons_Pvalb+
CAPZB	Interneurons_Pvalb+
CASK	Interneurons_Pvalb+
CASTOR2	Interneurons_Pvalb+
CBX3	Interneurons_Pvalb+
CCDC136	Interneurons_Pvalb+
CCDC191	Interneurons_Pvalb+
CCL27	Interneurons_Pvalb+
CCT2	Interneurons_Pvalb+
CCT5	Interneurons_Pvalb+
CCT7	Interneurons_Pvalb+
CCT8	Interneurons_Pvalb+
CD2AP	Interneurons_Pvalb+
CD47	Interneurons_Pvalb+
CDH12	Interneurons_Pvalb+
CDH6	Interneurons_Pvalb+
CDH9	Interneurons_Pvalb+
CDK14	Interneurons_Pvalb+
CDK17	Interneurons_Pvalb+
CDKL2	Interneurons_Pvalb+
CDS2	Interneurons_Pvalb+
CELF4	Interneurons_Pvalb+
CEMIP	Interneurons_Pvalb+
CENPV	Interneurons_Pvalb+
CEP290	Interneurons_Pvalb+
CEP78	Interneurons_Pvalb+
CEP83	Interneurons_Pvalb+
CEP85	Interneurons_Pvalb+
CEP97	Interneurons_Pvalb+
CERS6	Interneurons_Pvalb+
CHD2	Interneurons_Pvalb+
CHD4	Interneurons_Pvalb+
CHD9	Interneurons_Pvalb+
CHFR	Interneurons_Pvalb+
CHMP2A	Interneurons_Pvalb+
CHN1	Interneurons_Pvalb+
CHPF2	Interneurons_Pvalb+
CKB	Interneurons_Pvalb+
CLASP2	Interneurons_Pvalb+
CLCN3	Interneurons_Pvalb+
CLEC16A	Interneurons_Pvalb+
CLEC2L	Interneurons_Pvalb+
CLINT1	Interneurons_Pvalb+
CLK4	Interneurons_Pvalb+
CLOCK	Interneurons_Pvalb+
CMSS1	Interneurons_Pvalb+
CNR1	Interneurons_Pvalb+
CNTN2	Interneurons_Pvalb+
CNTNAP1	Interneurons_Pvalb+
CNTNAP2	Interneurons_Pvalb+
CNTNAP3C	Interneurons_Pvalb+
CNTNAP3B	Interneurons_Pvalb+
CNTNAP3	Interneurons_Pvalb+
COL26A1	Interneurons_Pvalb+
COMMD6	Interneurons_Pvalb+
COPS5	Interneurons_Pvalb+
COPS8	Interneurons_Pvalb+
CORO2B	Interneurons_Pvalb+
CORO6	Interneurons_Pvalb+
COX10	Interneurons_Pvalb+
COX16	Interneurons_Pvalb+
COX6A1	Interneurons_Pvalb+
COX7A2	Interneurons_Pvalb+
COX7C	Interneurons_Pvalb+
CPEB3	Interneurons_Pvalb+
CPNE6	Interneurons_Pvalb+
CREG2	Interneurons_Pvalb+
CSMD1	Interneurons_Pvalb+
CSMD3	Interneurons_Pvalb+
CSTF3	Interneurons_Pvalb+
CTIF	Interneurons_Pvalb+
CUL1	Interneurons_Pvalb+
CUX2	Interneurons_Pvalb+
CWC27	Interneurons_Pvalb+
CYFIP2	Interneurons_Pvalb+
CYTH1	Interneurons_Pvalb+
KIAA0232	Interneurons_Pvalb+
DAGLB	Interneurons_Pvalb+
DALRD3	Interneurons_Pvalb+
DCLK2	Interneurons_Pvalb+
DCTN4	Interneurons_Pvalb+
DCX	Interneurons_Pvalb+
DDB2	Interneurons_Pvalb+
DDX1	Interneurons_Pvalb+
DENND1A	Interneurons_Pvalb+
DEXI	Interneurons_Pvalb+
DGCR8	Interneurons_Pvalb+
DGKB	Interneurons_Pvalb+
DGKI	Interneurons_Pvalb+
DHX57	Interneurons_Pvalb+
DLG1	Interneurons_Pvalb+
DLG2	Interneurons_Pvalb+
DLGAP2	Interneurons_Pvalb+
DMTN	Interneurons_Pvalb+
DMXL2	Interneurons_Pvalb+
DNAJA3	Interneurons_Pvalb+
DNAJC13	Interneurons_Pvalb+
DNAL1	Interneurons_Pvalb+
DNM3	Interneurons_Pvalb+
DNMT3A	Interneurons_Pvalb+
DOCK10	Interneurons_Pvalb+
DOCK4	Interneurons_Pvalb+
DOCK9	Interneurons_Pvalb+
DPM3	Interneurons_Pvalb+
DPY19L3	Interneurons_Pvalb+
DTYMK	Interneurons_Pvalb+
DYNLL2	Interneurons_Pvalb+
EBNA1BP2	Interneurons_Pvalb+
EEF1A1	Interneurons_Pvalb+
EEF2	Interneurons_Pvalb+
EEFSEC	Interneurons_Pvalb+
EFNB2	Interneurons_Pvalb+
EFR3B	Interneurons_Pvalb+
EHBP1	Interneurons_Pvalb+
EIF2AK4	Interneurons_Pvalb+
EIF3CL	Interneurons_Pvalb+
EIF3C	Interneurons_Pvalb+
EIF4A3	Interneurons_Pvalb+
ELAVL2	Interneurons_Pvalb+
ELL2	Interneurons_Pvalb+
ELMO1	Interneurons_Pvalb+
EMC6	Interneurons_Pvalb+
EML5	Interneurons_Pvalb+
EML6	Interneurons_Pvalb+
EMSY	Interneurons_Pvalb+
ENAH	Interneurons_Pvalb+
ENO1	Interneurons_Pvalb+
ENO2	Interneurons_Pvalb+
EPB41	Interneurons_Pvalb+
EPB41L1	Interneurons_Pvalb+
EPC1	Interneurons_Pvalb+
EPHA10	Interneurons_Pvalb+
EPHA6	Interneurons_Pvalb+
EPHX4	Interneurons_Pvalb+
EPS15L1	Interneurons_Pvalb+
ERGIC2	Interneurons_Pvalb+
ESCO1	Interneurons_Pvalb+
ESRRG	Interneurons_Pvalb+
ETFA	Interneurons_Pvalb+
KIAA1217	Interneurons_Pvalb+
EXOC2	Interneurons_Pvalb+
EXOC4	Interneurons_Pvalb+
EXOC6B	Interneurons_Pvalb+
EYA4	Interneurons_Pvalb+
FAF2	Interneurons_Pvalb+
FAM120B	Interneurons_Pvalb+
FAM135B	Interneurons_Pvalb+
FAM171B	Interneurons_Pvalb+
FAM172A	Interneurons_Pvalb+
FAM174A	Interneurons_Pvalb+
FAM193B	Interneurons_Pvalb+
FAM219A	Interneurons_Pvalb+
FAM81A	Interneurons_Pvalb+
FARSA	Interneurons_Pvalb+
FAT3	Interneurons_Pvalb+
FBLL1	Interneurons_Pvalb+
FBXL16	Interneurons_Pvalb+
FBXL5	Interneurons_Pvalb+
FBXO44	Interneurons_Pvalb+
FBXO8	Interneurons_Pvalb+
FBXW4	Interneurons_Pvalb+
FER	Interneurons_Pvalb+
FEZ1	Interneurons_Pvalb+
FGF12	Interneurons_Pvalb+
FGFBP3	Interneurons_Pvalb+
FHIT	Interneurons_Pvalb+
FHOD3	Interneurons_Pvalb+
FILIP1	Interneurons_Pvalb+
FILIP1L	Interneurons_Pvalb+
FIS1	Interneurons_Pvalb+
FKBP1A	Interneurons_Pvalb+
FKBP1C	Interneurons_Pvalb+
FKBP8	Interneurons_Pvalb+
FLT3	Interneurons_Pvalb+
FMNL2	Interneurons_Pvalb+
FNIP2	Interneurons_Pvalb+
FOCAD	Interneurons_Pvalb+
FOXN3	Interneurons_Pvalb+
FOXP1	Interneurons_Pvalb+
FRMD7	Interneurons_Pvalb+
FRMPD1	Interneurons_Pvalb+
FRY	Interneurons_Pvalb+
FSTL5	Interneurons_Pvalb+
FTO	Interneurons_Pvalb+
FUBP1	Interneurons_Pvalb+
FUT9	Interneurons_Pvalb+
GABARAP	Interneurons_Pvalb+
GABARAPL1	Interneurons_Pvalb+
GABRA1	Interneurons_Pvalb+
GABRA3	Interneurons_Pvalb+
GABRB3	Interneurons_Pvalb+
GAD1	Interneurons_Pvalb+
GAL3ST1	Interneurons_Pvalb+
GALNT11	Interneurons_Pvalb+
GALNT13	Interneurons_Pvalb+
GALNT17	Interneurons_Pvalb+
GAPDH	Interneurons_Pvalb+
GARS1	Interneurons_Pvalb+
GAS7	Interneurons_Pvalb+
GATAD2A	Interneurons_Pvalb+
GEMIN5	Interneurons_Pvalb+
GGA1	Interneurons_Pvalb+
GGACT	Interneurons_Pvalb+
GLG1	Interneurons_Pvalb+
GLRB	Interneurons_Pvalb+
GLRX5	Interneurons_Pvalb+
GLYR1	Interneurons_Pvalb+
C11orf96	Interneurons_Pvalb+
SNURF	Interneurons_Pvalb+
GNB2	Interneurons_Pvalb+
GNB5	Interneurons_Pvalb+
GNL1	Interneurons_Pvalb+
GOLGB1	Interneurons_Pvalb+
GON7	Interneurons_Pvalb+
GPHN	Interneurons_Pvalb+
GPM6B	Interneurons_Pvalb+
GPR107	Interneurons_Pvalb+
GPR137C	Interneurons_Pvalb+
GPR176	Interneurons_Pvalb+
GPR22	Interneurons_Pvalb+
GPX4	Interneurons_Pvalb+
GRAMD1B	Interneurons_Pvalb+
C12orf57	Interneurons_Pvalb+
GRIA3	Interneurons_Pvalb+
GRID1	Interneurons_Pvalb+
GRIK2	Interneurons_Pvalb+
GRINA	Interneurons_Pvalb+
GRK3	Interneurons_Pvalb+
GRM5	Interneurons_Pvalb+
GUCY1A1	Interneurons_Pvalb+
GUCY1B1	Interneurons_Pvalb+
HM13	Interneurons_Pvalb+
H3-3A	Interneurons_Pvalb+
H3-5	Interneurons_Pvalb+
H3-3B	Interneurons_Pvalb+
HCFC1R1	Interneurons_Pvalb+
HCN1	Interneurons_Pvalb+
HCN2	Interneurons_Pvalb+
HDLBP	Interneurons_Pvalb+
HEATR5B	Interneurons_Pvalb+
HECW2	Interneurons_Pvalb+
HIBADH	Interneurons_Pvalb+
HINT1	Interneurons_Pvalb+
HIPK2	Interneurons_Pvalb+
HMGCLL1	Interneurons_Pvalb+
HNRNPA0	Interneurons_Pvalb+
HNRNPA2B1	Interneurons_Pvalb+
HNRNPA3	Interneurons_Pvalb+
HNRNPDL	Interneurons_Pvalb+
HNRNPH2	Interneurons_Pvalb+
HPRT1	Interneurons_Pvalb+
HSP90AB1	Interneurons_Pvalb+
HSPA8	Interneurons_Pvalb+
HSPE1	Interneurons_Pvalb+
HTR1F	Interneurons_Pvalb+
IARS1	Interneurons_Pvalb+
IGF1	Interneurons_Pvalb+
IGF1R	Interneurons_Pvalb+
IGSF21	Interneurons_Pvalb+
IGSF8	Interneurons_Pvalb+
IL11RA	Interneurons_Pvalb+
IL1RAPL1	Interneurons_Pvalb+
INAFM1	Interneurons_Pvalb+
INO80D	Interneurons_Pvalb+
INPP5J	Interneurons_Pvalb+
INSIG2	Interneurons_Pvalb+
INTS6	Interneurons_Pvalb+
IQGAP2	Interneurons_Pvalb+
IQSEC2	Interneurons_Pvalb+
IRS2	Interneurons_Pvalb+
ISCA2	Interneurons_Pvalb+
ITFG1	Interneurons_Pvalb+
JAK1	Interneurons_Pvalb+
JAZF1	Interneurons_Pvalb+
KALRN	Interneurons_Pvalb+
KAT6B	Interneurons_Pvalb+
KCNAB1	Interneurons_Pvalb+
KCNC1	Interneurons_Pvalb+
KCNC2	Interneurons_Pvalb+
KCNC3	Interneurons_Pvalb+
KCND3	Interneurons_Pvalb+
KCNIP1	Interneurons_Pvalb+
KCNIP2	Interneurons_Pvalb+
KCNMA1	Interneurons_Pvalb+
KCNQ3	Interneurons_Pvalb+
KCNQ5	Interneurons_Pvalb+
KCNS3	Interneurons_Pvalb+
KCNT1	Interneurons_Pvalb+
KCNT2	Interneurons_Pvalb+
KDM5A	Interneurons_Pvalb+
KDM5B	Interneurons_Pvalb+
KHDRBS3	Interneurons_Pvalb+
KIF21A	Interneurons_Pvalb+
KIF26B	Interneurons_Pvalb+
KIFAP3	Interneurons_Pvalb+
KLF12	Interneurons_Pvalb+
KLF9	Interneurons_Pvalb+
KRAS	Interneurons_Pvalb+
KRBA1	Interneurons_Pvalb+
LAMP1	Interneurons_Pvalb+
LANCL1	Interneurons_Pvalb+
LARS2	Interneurons_Pvalb+
LAS1L	Interneurons_Pvalb+
LDB1	Interneurons_Pvalb+
LGI2	Interneurons_Pvalb+
LGR5	Interneurons_Pvalb+
LIFR	Interneurons_Pvalb+
LMBR1	Interneurons_Pvalb+
LMO3	Interneurons_Pvalb+
LMO4	Interneurons_Pvalb+
LONP1	Interneurons_Pvalb+
LPP	Interneurons_Pvalb+
LRBA	Interneurons_Pvalb+
LRCH1	Interneurons_Pvalb+
LRCH3	Interneurons_Pvalb+
LRP1B	Interneurons_Pvalb+
LRP6	Interneurons_Pvalb+
LRPAP1	Interneurons_Pvalb+
LRRC20	Interneurons_Pvalb+
LRRC28	Interneurons_Pvalb+
LRRC3B	Interneurons_Pvalb+
LRRC49	Interneurons_Pvalb+
LRRC4C	Interneurons_Pvalb+
LRRFIP1	Interneurons_Pvalb+
LTBP4	Interneurons_Pvalb+
LUZP2	Interneurons_Pvalb+
MACO1	Interneurons_Pvalb+
MADD	Interneurons_Pvalb+
MAGI1	Interneurons_Pvalb+
MAGI2	Interneurons_Pvalb+
MAGI3	Interneurons_Pvalb+
MAN1C1	Interneurons_Pvalb+
MAP2	Interneurons_Pvalb+
MAP3K2	Interneurons_Pvalb+
MAP3K9	Interneurons_Pvalb+
MAPK4	Interneurons_Pvalb+
MAPK8IP2	Interneurons_Pvalb+
MAPK9	Interneurons_Pvalb+
MAPT	Interneurons_Pvalb+
MAST4	Interneurons_Pvalb+
MAU2	Interneurons_Pvalb+
MCPH1	Interneurons_Pvalb+
MDGA2	Interneurons_Pvalb+
MDH1	Interneurons_Pvalb+
MDM4	Interneurons_Pvalb+
ME2	Interneurons_Pvalb+
ME3	Interneurons_Pvalb+
MEGF10	Interneurons_Pvalb+
MEIS2	Interneurons_Pvalb+
MFN1	Interneurons_Pvalb+
MGLL	Interneurons_Pvalb+
MICAL2	Interneurons_Pvalb+
MICAL3	Interneurons_Pvalb+
MIGA2	Interneurons_Pvalb+
MIIP	Interneurons_Pvalb+
MOSMO	Interneurons_Pvalb+
MOXD1	Interneurons_Pvalb+
MPPED1	Interneurons_Pvalb+
MRPL12	Interneurons_Pvalb+
MRPL20	Interneurons_Pvalb+
MRPL3	Interneurons_Pvalb+
MRPL33	Interneurons_Pvalb+
MRPS34	Interneurons_Pvalb+
MRTFB	Interneurons_Pvalb+
MSI2	Interneurons_Pvalb+
MTA3	Interneurons_Pvalb+
MTCH1	Interneurons_Pvalb+
MTDH	Interneurons_Pvalb+
MTMR9	Interneurons_Pvalb+
MTURN	Interneurons_Pvalb+
MUS81	Interneurons_Pvalb+
MXI1	Interneurons_Pvalb+
MYO16	Interneurons_Pvalb+
MYO6	Interneurons_Pvalb+
NAALADL2	Interneurons_Pvalb+
NAE1	Interneurons_Pvalb+
NALCN	Interneurons_Pvalb+
NAP1L1	Interneurons_Pvalb+
NAT10	Interneurons_Pvalb+
NDST3	Interneurons_Pvalb+
NDUFA4	Interneurons_Pvalb+
NDUFA5	Interneurons_Pvalb+
NDUFAF3	Interneurons_Pvalb+
NDUFB2	Interneurons_Pvalb+
NDUFB4	Interneurons_Pvalb+
NDUFS2	Interneurons_Pvalb+
NDUFV1	Interneurons_Pvalb+
NEBL	Interneurons_Pvalb+
NECAB1	Interneurons_Pvalb+
NECTIN3	Interneurons_Pvalb+
NEDD4	Interneurons_Pvalb+
NEDD4L	Interneurons_Pvalb+
NEK7	Interneurons_Pvalb+
NELFB	Interneurons_Pvalb+
NETO2	Interneurons_Pvalb+
NEXMIF	Interneurons_Pvalb+
NFASC	Interneurons_Pvalb+
NFXL1	Interneurons_Pvalb+
NGEF	Interneurons_Pvalb+
NIPA2	Interneurons_Pvalb+
NISCH	Interneurons_Pvalb+
NIT1	Interneurons_Pvalb+
NLGN1	Interneurons_Pvalb+
NMT1	Interneurons_Pvalb+
NOL11	Interneurons_Pvalb+
NOP56	Interneurons_Pvalb+
NOS1AP	Interneurons_Pvalb+
NOVA1	Interneurons_Pvalb+
NPAT	Interneurons_Pvalb+
NPTN	Interneurons_Pvalb+
NR2C2	Interneurons_Pvalb+
NRCAM	Interneurons_Pvalb+
NRXN1	Interneurons_Pvalb+
NSD1	Interneurons_Pvalb+
NT5M	Interneurons_Pvalb+
NTRK3	Interneurons_Pvalb+
NUDC	Interneurons_Pvalb+
NUDCD3	Interneurons_Pvalb+
NUDT5	Interneurons_Pvalb+
NXPH2	Interneurons_Pvalb+
OAZ1	Interneurons_Pvalb+
ODR4	Interneurons_Pvalb+
OGDHL	Interneurons_Pvalb+
OPRD1	Interneurons_Pvalb+
ORC2	Interneurons_Pvalb+
OSBPL1A	Interneurons_Pvalb+
OSBPL3	Interneurons_Pvalb+
OSBPL8	Interneurons_Pvalb+
PABPC4	Interneurons_Pvalb+
PACS1	Interneurons_Pvalb+
PAG1	Interneurons_Pvalb+
PAICS	Interneurons_Pvalb+
PAM	Interneurons_Pvalb+
PAM16	Interneurons_Pvalb+
PBX1	Interneurons_Pvalb+
PBX3	Interneurons_Pvalb+
PCBP3	Interneurons_Pvalb+
PCDH7	Interneurons_Pvalb+
PCED1B	Interneurons_Pvalb+
PCGF6	Interneurons_Pvalb+
PCMTD1	Interneurons_Pvalb+
PCNX3	Interneurons_Pvalb+
PCSK2	Interneurons_Pvalb+
PDCD6	Interneurons_Pvalb+
PDE10A	Interneurons_Pvalb+
PDE1C	Interneurons_Pvalb+
PDE4A	Interneurons_Pvalb+
PDE4B	Interneurons_Pvalb+
PDE9A	Interneurons_Pvalb+
PDPR	Interneurons_Pvalb+
PDXK	Interneurons_Pvalb+
PDZD2	Interneurons_Pvalb+
PDZRN4	Interneurons_Pvalb+
PEX3	Interneurons_Pvalb+
PFDN2	Interneurons_Pvalb+
PFDN6	Interneurons_Pvalb+
PGGT1B	Interneurons_Pvalb+
PHACTR2	Interneurons_Pvalb+
PHC2	Interneurons_Pvalb+
PHF1	Interneurons_Pvalb+
PHF20L1	Interneurons_Pvalb+
PHKB	Interneurons_Pvalb+
PIK3R1	Interneurons_Pvalb+
PJA2	Interneurons_Pvalb+
PKM	Interneurons_Pvalb+
PKN2	Interneurons_Pvalb+
PLCB4	Interneurons_Pvalb+
PLEKHA7	Interneurons_Pvalb+
PLEKHM2	Interneurons_Pvalb+
PLK4	Interneurons_Pvalb+
PLPPR1	Interneurons_Pvalb+
PLPPR4	Interneurons_Pvalb+
PLPPR5	Interneurons_Pvalb+
PLXNC1	Interneurons_Pvalb+
PNPLA8	Interneurons_Pvalb+
POLR2C	Interneurons_Pvalb+
POT1	Interneurons_Pvalb+
PPARGC1A	Interneurons_Pvalb+
PPAT	Interneurons_Pvalb+
PPIP5K2	Interneurons_Pvalb+
PPP1R12A	Interneurons_Pvalb+
PPP1R12B	Interneurons_Pvalb+
PPP1R2	Interneurons_Pvalb+
PPP1R2B	Interneurons_Pvalb+
PPP2R2B	Interneurons_Pvalb+
PPP2R2D	Interneurons_Pvalb+
PPP3CA	Interneurons_Pvalb+
PRDM10	Interneurons_Pvalb+
PRKCA	Interneurons_Pvalb+
PRKCI	Interneurons_Pvalb+
PRUNE2	Interneurons_Pvalb+
PSENEN	Interneurons_Pvalb+
PSIP1	Interneurons_Pvalb+
PSMA7	Interneurons_Pvalb+
PSMB3	Interneurons_Pvalb+
PSMD7	Interneurons_Pvalb+
PSME3	Interneurons_Pvalb+
PSTPIP2	Interneurons_Pvalb+
PTDSS1	Interneurons_Pvalb+
PTEN	Interneurons_Pvalb+
PTPDC1	Interneurons_Pvalb+
PTPN1	Interneurons_Pvalb+
PTPN23	Interneurons_Pvalb+
PTPN9	Interneurons_Pvalb+
PTPRE	Interneurons_Pvalb+
PTPRO	Interneurons_Pvalb+
PXK	Interneurons_Pvalb+
QKI	Interneurons_Pvalb+
R3HDM4	Interneurons_Pvalb+
RAB14	Interneurons_Pvalb+
RAB27B	Interneurons_Pvalb+
RAB2A	Interneurons_Pvalb+
RABEPK	Interneurons_Pvalb+
RABGAP1	Interneurons_Pvalb+
RAD51C	Interneurons_Pvalb+
RAE1	Interneurons_Pvalb+
RALA	Interneurons_Pvalb+
RAP1GAP	Interneurons_Pvalb+
RAPGEF2	Interneurons_Pvalb+
RAPGEF4	Interneurons_Pvalb+
RAPGEF5	Interneurons_Pvalb+
RAPGEF6	Interneurons_Pvalb+
RAPH1	Interneurons_Pvalb+
RARB	Interneurons_Pvalb+
RASA1	Interneurons_Pvalb+
RASGRF2	Interneurons_Pvalb+
RB1	Interneurons_Pvalb+
RBFA	Interneurons_Pvalb+
RBFOX1	Interneurons_Pvalb+
RBM10	Interneurons_Pvalb+
RBM15	Interneurons_Pvalb+
RBM25	Interneurons_Pvalb+
RBM28	Interneurons_Pvalb+
RBMX	Interneurons_Pvalb+
REEP1	Interneurons_Pvalb+
RERE	Interneurons_Pvalb+
RETREG2	Interneurons_Pvalb+
REV3L	Interneurons_Pvalb+
RIF1	Interneurons_Pvalb+
RIMBP2	Interneurons_Pvalb+
RIMS4	Interneurons_Pvalb+
RIPK2	Interneurons_Pvalb+
RIPOR2	Interneurons_Pvalb+
RNF112	Interneurons_Pvalb+
RNF144B	Interneurons_Pvalb+
RNF180	Interneurons_Pvalb+
RNF41	Interneurons_Pvalb+
RNPC3	Interneurons_Pvalb+
ROBO2	Interneurons_Pvalb+
ROGDI	Interneurons_Pvalb+
RPEL1	Interneurons_Pvalb+
RPE	Interneurons_Pvalb+
RPGRIP1L	Interneurons_Pvalb+
RPL13	Interneurons_Pvalb+
RPL22L1	Interneurons_Pvalb+
RPS2	Interneurons_Pvalb+
RPS20	Interneurons_Pvalb+
RPS6KA2	Interneurons_Pvalb+
RRP1	Interneurons_Pvalb+
RSF1	Interneurons_Pvalb+
RSPH3	Interneurons_Pvalb+
RSRC2	Interneurons_Pvalb+
RSRP1	Interneurons_Pvalb+
RTL4	Interneurons_Pvalb+
RTN1	Interneurons_Pvalb+
RTN3	Interneurons_Pvalb+
RTN4IP1	Interneurons_Pvalb+
RUNDC1	Interneurons_Pvalb+
RUNX1T1	Interneurons_Pvalb+
RUNX2	Interneurons_Pvalb+
SAFB	Interneurons_Pvalb+
SAMD5	Interneurons_Pvalb+
SATB1	Interneurons_Pvalb+
SCAF4	Interneurons_Pvalb+
SCAMP1	Interneurons_Pvalb+
SCAMP5	Interneurons_Pvalb+
SCN1B	Interneurons_Pvalb+
SCN5A	Interneurons_Pvalb+
SCN8A	Interneurons_Pvalb+
SEC24B	Interneurons_Pvalb+
SEC61A2	Interneurons_Pvalb+
SELENOF	Interneurons_Pvalb+
SELENOI	Interneurons_Pvalb+
SELENOK	Interneurons_Pvalb+
SEMA3C	Interneurons_Pvalb+
SEMA3E	Interneurons_Pvalb+
SEMA7A	Interneurons_Pvalb+
SFXN5	Interneurons_Pvalb+
SGCE	Interneurons_Pvalb+
SHC3	Interneurons_Pvalb+
SHISA7	Interneurons_Pvalb+
SIK3	Interneurons_Pvalb+
SLC15A4	Interneurons_Pvalb+
SLC1A1	Interneurons_Pvalb+
SLC1A2	Interneurons_Pvalb+
SLC25A14	Interneurons_Pvalb+
SLC25A4	Interneurons_Pvalb+
SLC25A46	Interneurons_Pvalb+
SLC25A53	Interneurons_Pvalb+
SLC32A1	Interneurons_Pvalb+
SLC35C2	Interneurons_Pvalb+
SLC35F1	Interneurons_Pvalb+
SLC35F3	Interneurons_Pvalb+
SLC39A13	Interneurons_Pvalb+
SLC44A5	Interneurons_Pvalb+
SLC4A4	Interneurons_Pvalb+
SLC6A9	Interneurons_Pvalb+
SLC7A5	Interneurons_Pvalb+
SLC8A1	Interneurons_Pvalb+
SLC8A3	Interneurons_Pvalb+
SLF1	Interneurons_Pvalb+
SLIT2	Interneurons_Pvalb+
SLIT3	Interneurons_Pvalb+
SLMAP	Interneurons_Pvalb+
SMG1	Interneurons_Pvalb+
SMIM14	Interneurons_Pvalb+
SMIM26	Interneurons_Pvalb+
SNAP25	Interneurons_Pvalb+
SNPH	Interneurons_Pvalb+
SNX13	Interneurons_Pvalb+
SOBP	Interneurons_Pvalb+
SORBS1	Interneurons_Pvalb+
SORCS2	Interneurons_Pvalb+
SORT1	Interneurons_Pvalb+
SOS2	Interneurons_Pvalb+
SOX6	Interneurons_Pvalb+
SPARCL1	Interneurons_Pvalb+
SPATA1	Interneurons_Pvalb+
SPATS2L	Interneurons_Pvalb+
SPECC1L-ADORA2A	Interneurons_Pvalb+
SPECC1L	Interneurons_Pvalb+
SPART	Interneurons_Pvalb+
SPHKAP	Interneurons_Pvalb+
SPINDOC	Interneurons_Pvalb+
SPTB	Interneurons_Pvalb+
SRGAP3	Interneurons_Pvalb+
SRRM4	Interneurons_Pvalb+
SRSF2	Interneurons_Pvalb+
SSBP2	Interneurons_Pvalb+
ST6GALNAC3	Interneurons_Pvalb+
STAMBPL1	Interneurons_Pvalb+
STK19	Interneurons_Pvalb+
STK32B	Interneurons_Pvalb+
STRBP	Interneurons_Pvalb+
STT3A	Interneurons_Pvalb+
STXBP3	Interneurons_Pvalb+
STXBP5	Interneurons_Pvalb+
STXBP6	Interneurons_Pvalb+
SUCLA2	Interneurons_Pvalb+
SYN2	Interneurons_Pvalb+
SYN3	Interneurons_Pvalb+
SYNE1	Interneurons_Pvalb+
SYNJ1	Interneurons_Pvalb+
SYNPR	Interneurons_Pvalb+
SYT16	Interneurons_Pvalb+
SYT5	Interneurons_Pvalb+
TAF1D	Interneurons_Pvalb+
TAGLN3	Interneurons_Pvalb+
TAOK1	Interneurons_Pvalb+
TASP1	Interneurons_Pvalb+
TATDN3	Interneurons_Pvalb+
TAFAZZIN	Interneurons_Pvalb+
TBC1D12	Interneurons_Pvalb+
TBC1D9	Interneurons_Pvalb+
TCEAL3	Interneurons_Pvalb+
TCEAL6	Interneurons_Pvalb+
TCEAL5	Interneurons_Pvalb+
TCERG1	Interneurons_Pvalb+
TCP11L1	Interneurons_Pvalb+
TENM2	Interneurons_Pvalb+
TET2	Interneurons_Pvalb+
TGFBR2	Interneurons_Pvalb+
TGFBRAP1	Interneurons_Pvalb+
THRA	Interneurons_Pvalb+
THRB	Interneurons_Pvalb+
TIAM1	Interneurons_Pvalb+
TIMM13	Interneurons_Pvalb+
TIMM23	Interneurons_Pvalb+
TIMM8B	Interneurons_Pvalb+
TLE1	Interneurons_Pvalb+
TLL1	Interneurons_Pvalb+
TM9SF3	Interneurons_Pvalb+
TMA7	Interneurons_Pvalb+
TMBIM4	Interneurons_Pvalb+
TMBIM6	Interneurons_Pvalb+
TMCC1	Interneurons_Pvalb+
TMED9	Interneurons_Pvalb+
TMEM131	Interneurons_Pvalb+
TMEM132C	Interneurons_Pvalb+
TMEM132D	Interneurons_Pvalb+
TMEM147	Interneurons_Pvalb+
TMEM175	Interneurons_Pvalb+
TMEM186	Interneurons_Pvalb+
TMEM216	Interneurons_Pvalb+
TMEM44	Interneurons_Pvalb+
TMEM50A	Interneurons_Pvalb+
TMEM65	Interneurons_Pvalb+
TMSB4Y	Interneurons_Pvalb+
TNR	Interneurons_Pvalb+
TNRC18	Interneurons_Pvalb+
TNRC6A	Interneurons_Pvalb+
TNRC6B	Interneurons_Pvalb+
TOMM40	Interneurons_Pvalb+
TOP1	Interneurons_Pvalb+
TOP2B	Interneurons_Pvalb+
TOR1AIP2	Interneurons_Pvalb+
TOX3	Interneurons_Pvalb+
TPI1	Interneurons_Pvalb+
TPR	Interneurons_Pvalb+
TPRKB	Interneurons_Pvalb+
TPST1	Interneurons_Pvalb+
TRA2A	Interneurons_Pvalb+
TRIM35	Interneurons_Pvalb+
TRIP4	Interneurons_Pvalb+
TRMT112	Interneurons_Pvalb+
TRPC4	Interneurons_Pvalb+
TSC1	Interneurons_Pvalb+
TSPAN13	Interneurons_Pvalb+
TSPAN3	Interneurons_Pvalb+
TTC21B	Interneurons_Pvalb+
TTC28	Interneurons_Pvalb+
TTL	Interneurons_Pvalb+
TTLL11	Interneurons_Pvalb+
TTLL7	Interneurons_Pvalb+
TUBB2A	Interneurons_Pvalb+
TUBGCP2	Interneurons_Pvalb+
TUBGCP3	Interneurons_Pvalb+
TULP3	Interneurons_Pvalb+
TXNDC15	Interneurons_Pvalb+
U2SURP	Interneurons_Pvalb+
UBB	Interneurons_Pvalb+
UBR2	Interneurons_Pvalb+
UBR5	Interneurons_Pvalb+
UBTF	Interneurons_Pvalb+
UCHL1	Interneurons_Pvalb+
UEVLD	Interneurons_Pvalb+
UNC5C	Interneurons_Pvalb+
UNC5D	Interneurons_Pvalb+
UQCC1	Interneurons_Pvalb+
UQCRC2	Interneurons_Pvalb+
UQCRQ	Interneurons_Pvalb+
UTRN	Interneurons_Pvalb+
UVRAG	Interneurons_Pvalb+
VAV2	Interneurons_Pvalb+
VCL	Interneurons_Pvalb+
VOPP1	Interneurons_Pvalb+
VPS29	Interneurons_Pvalb+
VPS41	Interneurons_Pvalb+
VPS8	Interneurons_Pvalb+
VSTM2B	Interneurons_Pvalb+
VSTM5	Interneurons_Pvalb+
VWA8	Interneurons_Pvalb+
WAC	Interneurons_Pvalb+
WAPL	Interneurons_Pvalb+
WASF1	Interneurons_Pvalb+
WDFY3	Interneurons_Pvalb+
WDR17	Interneurons_Pvalb+
WDR33	Interneurons_Pvalb+
WNK1	Interneurons_Pvalb+
WNK3	Interneurons_Pvalb+
WWOX	Interneurons_Pvalb+
XKR4	Interneurons_Pvalb+
XPR1	Interneurons_Pvalb+
XYLT2	Interneurons_Pvalb+
YEATS2	Interneurons_Pvalb+
YIPF6	Interneurons_Pvalb+
YWHAZ	Interneurons_Pvalb+
ZBTB11	Interneurons_Pvalb+
ZBTB16	Interneurons_Pvalb+
ZBTB20	Interneurons_Pvalb+
ZBTB38	Interneurons_Pvalb+
ZC3H6	Interneurons_Pvalb+
ZEB1	Interneurons_Pvalb+
ZEB2	Interneurons_Pvalb+
ZFAND3	Interneurons_Pvalb+
ZNF329	Interneurons_Pvalb+
ZNF365	Interneurons_Pvalb+
ZNF383	Interneurons_Pvalb+
ZNF398	Interneurons_Pvalb+
ZNF426	Interneurons_Pvalb+
ZNF532	Interneurons_Pvalb+
ZNF608	Interneurons_Pvalb+
ZNF618	Interneurons_Pvalb+
ZNF639	Interneurons_Pvalb+
ZNF652	Interneurons_Pvalb+
ZNF804A	Interneurons_Pvalb+
ZKSCAN2	Interneurons_Pvalb+
ZMAT3	Interneurons_Pvalb+
ZMYM6	Interneurons_Pvalb+
ZSCAN26	Interneurons_Pvalb+
ATP2A2	Interneurons_Sst+
COX7C	Interneurons_Sst+
CPNE5	Interneurons_Sst+
DPM3	Interneurons_Sst+
FAM174A	Interneurons_Sst+
HINT1	Interneurons_Sst+
KCNIP2	Interneurons_Sst+
MRPS34	Interneurons_Sst+
NALCN	Interneurons_Sst+
NDRG4	Interneurons_Sst+
PPP1R2	Interneurons_Sst+
PPP1R2B	Interneurons_Sst+
PSMA7	Interneurons_Sst+
RASL10B	Interneurons_Sst+
RGS9	Interneurons_Sst+
RPL22L1	Interneurons_Sst+
SST	Interneurons_Sst+
TIMM8B	Interneurons_Sst+
WASF1	Interneurons_Sst+
ABHD14A	Interneurons_Th+
ACTB	Interneurons_Th+
AKAP7	Interneurons_Th+
APEX1	Interneurons_Th+
ARPP21	Interneurons_Th+
ATP2A2	Interneurons_Th+
ATP5PF	Interneurons_Th+
ATP6V1E1	Interneurons_Th+
ATP6V1F	Interneurons_Th+
BEX2	Interneurons_Th+
BEX1	Interneurons_Th+
BHLHB9	Interneurons_Th+
BRI3	Interneurons_Th+
BTF3	Interneurons_Th+
CACNA2D1	Interneurons_Th+
CACNB2	Interneurons_Th+
CAPZA2	Interneurons_Th+
CA10	Interneurons_Th+
CASKIN1	Interneurons_Th+
CCT2	Interneurons_Th+
CHD7	Interneurons_Th+
CHMP2A	Interneurons_Th+
CKB	Interneurons_Th+
CNTN5	Interneurons_Th+
CNTNAP4	Interneurons_Th+
COX6A1	Interneurons_Th+
COX7A2	Interneurons_Th+
COX7C	Interneurons_Th+
CPLX2	Interneurons_Th+
CPNE5	Interneurons_Th+
CREG2	Interneurons_Th+
CYTH2	Interneurons_Th+
DOC2B	Interneurons_Th+
DUSP8	Interneurons_Th+
ECH1	Interneurons_Th+
EEF1A1	Interneurons_Th+
EIF3CL	Interneurons_Th+
EIF3C	Interneurons_Th+
EMC6	Interneurons_Th+
FAM171A2	Interneurons_Th+
FBLL1	Interneurons_Th+
FOXO1	Interneurons_Th+
GABARAP	Interneurons_Th+
GABARAPL1	Interneurons_Th+
C11orf96	Interneurons_Th+
GNB2	Interneurons_Th+
GNB5	Interneurons_Th+
GPX4	Interneurons_Th+
C12orf57	Interneurons_Th+
H3-3A	Interneurons_Th+
HINT1	Interneurons_Th+
HNRNPA0	Interneurons_Th+
HSP90AB1	Interneurons_Th+
HSPE1	Interneurons_Th+
IGSF8	Interneurons_Th+
IMP3	Interneurons_Th+
INPP4B	Interneurons_Th+
KCND3	Interneurons_Th+
KIT	Interneurons_Th+
LRRC73	Interneurons_Th+
LZTS3	Interneurons_Th+
MARCKS	Interneurons_Th+
MAT2B	Interneurons_Th+
MRPL20	Interneurons_Th+
MTCH1	Interneurons_Th+
MTERF1	Interneurons_Th+
NACA	Interneurons_Th+
NDRG4	Interneurons_Th+
NDUFB9	Interneurons_Th+
NDUFS2	Interneurons_Th+
NDUFV1	Interneurons_Th+
NECAB2	Interneurons_Th+
NGEF	Interneurons_Th+
NLGN1	Interneurons_Th+
NUDC	Interneurons_Th+
OAZ1	Interneurons_Th+
OLFM3	Interneurons_Th+
PDCD6	Interneurons_Th+
PDXK	Interneurons_Th+
PIN1	Interneurons_Th+
PKM	Interneurons_Th+
PLA2G7	Interneurons_Th+
POLR2G	Interneurons_Th+
PPP1R2	Interneurons_Th+
PPP1R2B	Interneurons_Th+
PPP2R2B	Interneurons_Th+
PSENEN	Interneurons_Th+
PSMA7	Interneurons_Th+
RAB3A	Interneurons_Th+
RACK1	Interneurons_Th+
RASGRP2	Interneurons_Th+
RPL22L1	Interneurons_Th+
RPL35	Interneurons_Th+
RPN1	Interneurons_Th+
RPS2	Interneurons_Th+
RRAGD	Interneurons_Th+
RSRP1	Interneurons_Th+
SDHAF4	Interneurons_Th+
SDK1	Interneurons_Th+
SFMBT2	Interneurons_Th+
SLC1A3	Interneurons_Th+
SLC22A17	Interneurons_Th+
SMPD1	Interneurons_Th+
SPARCL1	Interneurons_Th+
SPOCK3	Interneurons_Th+
SRM	Interneurons_Th+
TCF7L2	Interneurons_Th+
TIMM13	Interneurons_Th+
TIMM8B	Interneurons_Th+
TMA7	Interneurons_Th+
TMEM147	Interneurons_Th+
TPI1	Interneurons_Th+
UBTF	Interneurons_Th+
UNC5D	Interneurons_Th+
UQCRQ	Interneurons_Th+
WASF1	Interneurons_Th+
ZNF804B	Interneurons_Th+
AAMP	Microglia
AARS1	Microglia
AKAP9	Microglia
ALAS1	Microglia
AP5Z1	Microglia
ARHGAP32	Microglia
ARPC3	Microglia
ATP6V0B	Microglia
ATP6V1G1	Microglia
BBS5	Microglia
C18orf32	Microglia
CACNA1D	Microglia
CCDC149	Microglia
CCDC174	Microglia
CCDC47	Microglia
CCND3	Microglia
CCT8	Microglia
CD81	Microglia
CDC42EP3	Microglia
CDK8	Microglia
CERS6	Microglia
CHMP4B	Microglia
DAPK3	Microglia
DCLK1	Microglia
DCTN6	Microglia
DCUN1D4	Microglia
DNAJB11	Microglia
DYNC1H1	Microglia
EIF3B	Microglia
ENSA	Microglia
ERH	Microglia
FAM214A	Microglia
FAT3	Microglia
FBXW7	Microglia
FMN2	Microglia
FTL	Microglia
GABARAP	Microglia
GATAD1	Microglia
GLG1	Microglia
GMPS	Microglia
GOLGB1	Microglia
HNRNPK	Microglia
INSIG2	Microglia
JADE1	Microglia
KCNMA1	Microglia
KLF9	Microglia
LMBRD2	Microglia
LPL	Microglia
MCTP1	Microglia
METAP2	Microglia
MGAT2	Microglia
MICU3	Microglia
MKRN1	Microglia
MORF4L2	Microglia
MRPL18	Microglia
MRPL33	Microglia
MRPS22	Microglia
MT1G	Microglia
NKAIN2	Microglia
NPTN	Microglia
NUCB2	Microglia
P3H2	Microglia
PBX3	Microglia
PCDH9	Microglia
PHB2	Microglia
PHYHIPL	Microglia
PLPP3	Microglia
PLPP7	Microglia
POLR2K	Microglia
PPTC7	Microglia
PRDX1	Microglia
PRKCE	Microglia
PSD3	Microglia
PSENEN	Microglia
PSMB1	Microglia
R3HDM1	Microglia
RAB6B	Microglia
RANGAP1	Microglia
RAP1GAP2	Microglia
ROGDI	Microglia
SCN1B	Microglia
SIPA1L1	Microglia
SLC1A2	Microglia
SLC35B1	Microglia
SNX17	Microglia
SORL1	Microglia
SPATA7	Microglia
SS18L2	Microglia
SSNA1	Microglia
SSR3	Microglia
STK25	Microglia
STRBP	Microglia
TENT4A	Microglia
TOMM70	Microglia
TXNRD1	Microglia
VPS29	Microglia
VPS52	Microglia
WDR17	Microglia
YPEL3	Microglia
YWHAG	Microglia
YWHAH	Microglia
C8orf34	MSN_Drd1+_1
ACSL3	MSN_Drd1+_1
ACTG1	MSN_Drd1+_1
ACTN2	MSN_Drd1+_1
ACVR1C	MSN_Drd1+_1
ACVR2A	MSN_Drd1+_1
ADAM12	MSN_Drd1+_1
ADGRB1	MSN_Drd1+_1
ANO3	MSN_Drd1+_1
ANO4	MSN_Drd1+_1
ARHGAP10	MSN_Drd1+_1
ARL6IP1	MSN_Drd1+_1
ATP1B1	MSN_Drd1+_1
ATP2A2	MSN_Drd1+_1
ATP5MC3	MSN_Drd1+_1
ATP5MF	MSN_Drd1+_1
ATP6AP2	MSN_Drd1+_1
ATP6V0C	MSN_Drd1+_1
ATP6V1E1	MSN_Drd1+_1
CADM1	MSN_Drd1+_1
CALM1	MSN_Drd1+_1
CA12	MSN_Drd1+_1
CARTPT	MSN_Drd1+_1
CCDC85A	MSN_Drd1+_1
CCT2	MSN_Drd1+_1
CDIPT	MSN_Drd1+_1
CDK5R1	MSN_Drd1+_1
CELF3	MSN_Drd1+_1
CHGA	MSN_Drd1+_1
CHN2	MSN_Drd1+_1
CNTN4	MSN_Drd1+_1
CNTN5	MSN_Drd1+_1
COX7C	MSN_Drd1+_1
CPNE4	MSN_Drd1+_1
CSPG5	MSN_Drd1+_1
DACH1	MSN_Drd1+_1
DGKI	MSN_Drd1+_1
DLK1	MSN_Drd1+_1
DNAJB11	MSN_Drd1+_1
DNER	MSN_Drd1+_1
DOCK10	MSN_Drd1+_1
DOK6	MSN_Drd1+_1
DPYD	MSN_Drd1+_1
DYNLL1	MSN_Drd1+_1
EBF1	MSN_Drd1+_1
EEF1A2	MSN_Drd1+_1
EIF1	MSN_Drd1+_1
EMC7	MSN_Drd1+_1
ENC1	MSN_Drd1+_1
EPB41	MSN_Drd1+_1
NALF1	MSN_Drd1+_1
FGF13	MSN_Drd1+_1
FOXP1	MSN_Drd1+_1
FRMD4B	MSN_Drd1+_1
FSTL4	MSN_Drd1+_1
FTH1	MSN_Drd1+_1
GAA	MSN_Drd1+_1
GALNTL6	MSN_Drd1+_1
GAPDH	MSN_Drd1+_1
GAREM1	MSN_Drd1+_1
GDE1	MSN_Drd1+_1
GNAS	MSN_Drd1+_1
GOT1	MSN_Drd1+_1
GPC5	MSN_Drd1+_1
GPM6B	MSN_Drd1+_1
GREB1L	MSN_Drd1+_1
GRIA3	MSN_Drd1+_1
GRM1	MSN_Drd1+_1
GRM3	MSN_Drd1+_1
GRM8	MSN_Drd1+_1
GSG1L	MSN_Drd1+_1
HCN1	MSN_Drd1+_1
HS6ST3	MSN_Drd1+_1
HSP90AA1	MSN_Drd1+_1
HSP90AB1	MSN_Drd1+_1
HSP90B1	MSN_Drd1+_1
HSPA8	MSN_Drd1+_1
HTR4	MSN_Drd1+_1
INF2	MSN_Drd1+_1
INPP4B	MSN_Drd1+_1
ITM2B	MSN_Drd1+_1
ITM2C	MSN_Drd1+_1
ITPR1	MSN_Drd1+_1
KBTBD11	MSN_Drd1+_1
KCNC2	MSN_Drd1+_1
KCND3	MSN_Drd1+_1
KCNH7	MSN_Drd1+_1
KCNK1	MSN_Drd1+_1
KIFAP3	MSN_Drd1+_1
LRRTM4	MSN_Drd1+_1
LRTM1	MSN_Drd1+_1
LSAMP	MSN_Drd1+_1
LY6H	MSN_Drd1+_1
MAPK4	MSN_Drd1+_1
MAST4	MSN_Drd1+_1
MGAT4C	MSN_Drd1+_1
MPPED2	MSN_Drd1+_1
NDUFB10	MSN_Drd1+_1
NEDD4	MSN_Drd1+_1
NELL1	MSN_Drd1+_1
NEXN	MSN_Drd1+_1
NHS	MSN_Drd1+_1
NME7	MSN_Drd1+_1
NOP10	MSN_Drd1+_1
NPAS3	MSN_Drd1+_1
NPSR1	MSN_Drd1+_1
NRG1	MSN_Drd1+_1
NRP1	MSN_Drd1+_1
NSG1	MSN_Drd1+_1
NTM	MSN_Drd1+_1
ONECUT2	MSN_Drd1+_1
OXR1	MSN_Drd1+_1
PACRG	MSN_Drd1+_1
PAM16	MSN_Drd1+_1
PARD3B	MSN_Drd1+_1
PCDH15	MSN_Drd1+_1
PCDH7	MSN_Drd1+_1
PCSK1N	MSN_Drd1+_1
PDE10A	MSN_Drd1+_1
PDE11A	MSN_Drd1+_1
PDE1A	MSN_Drd1+_1
PDE4D	MSN_Drd1+_1
PDE7B	MSN_Drd1+_1
PDIA3	MSN_Drd1+_1
PEAK1	MSN_Drd1+_1
PGRMC1	MSN_Drd1+_1
PID1	MSN_Drd1+_1
PLCXD3	MSN_Drd1+_1
PLXNA4	MSN_Drd1+_1
PRDX6	MSN_Drd1+_1
PRR16	MSN_Drd1+_1
PSAP	MSN_Drd1+_1
PTN	MSN_Drd1+_1
PTPRZ1	MSN_Drd1+_1
RALYL	MSN_Drd1+_1
RASGEF1B	MSN_Drd1+_1
REEP5	MSN_Drd1+_1
RELN	MSN_Drd1+_1
RPL22L1	MSN_Drd1+_1
RSRP1	MSN_Drd1+_1
SCG3	MSN_Drd1+_1
SDK1	MSN_Drd1+_1
SEC62	MSN_Drd1+_1
SELENOF	MSN_Drd1+_1
SELENOM	MSN_Drd1+_1
SERINC1	MSN_Drd1+_1
SERTAD2	MSN_Drd1+_1
SEZ6L	MSN_Drd1+_1
SH2D5	MSN_Drd1+_1
SH3RF2	MSN_Drd1+_1
SIDT1	MSN_Drd1+_1
SLC25A4	MSN_Drd1+_1
SLC35F4	MSN_Drd1+_1
SLC4A4	MSN_Drd1+_1
SLC8A1	MSN_Drd1+_1
SNTG2	MSN_Drd1+_1
SORCS1	MSN_Drd1+_1
SPON1	MSN_Drd1+_1
STK32A	MSN_Drd1+_1
STMN2	MSN_Drd1+_1
STMN3	MSN_Drd1+_1
STRN	MSN_Drd1+_1
SUB1	MSN_Drd1+_1
SYNE1	MSN_Drd1+_1
SYP	MSN_Drd1+_1
SYT11	MSN_Drd1+_1
TAC1	MSN_Drd1+_1
TBC1D8	MSN_Drd1+_1
TCERG1L	MSN_Drd1+_1
TECR	MSN_Drd1+_1
TENM1	MSN_Drd1+_1
TGFA	MSN_Drd1+_1
THSD7A	MSN_Drd1+_1
TIMM8B	MSN_Drd1+_1
TMA7	MSN_Drd1+_1
TMEM132A	MSN_Drd1+_1
TMEM30A	MSN_Drd1+_1
TRPM3	MSN_Drd1+_1
TSHZ2	MSN_Drd1+_1
TSPYL4	MSN_Drd1+_1
TUBB2A	MSN_Drd1+_1
UBB	MSN_Drd1+_1
UNC5C	MSN_Drd1+_1
UNC5D	MSN_Drd1+_1
UQCR10	MSN_Drd1+_1
USP29	MSN_Drd1+_1
VSNL1	MSN_Drd1+_1
ABHD17A	MSN_Drd1+_2
ABHD8	MSN_Drd1+_2
ABLIM1	MSN_Drd1+_2
ACSL3	MSN_Drd1+_2
ACTB	MSN_Drd1+_2
ACTG1	MSN_Drd1+_2
ADGRB1	MSN_Drd1+_2
ADSS2	MSN_Drd1+_2
ALDOA	MSN_Drd1+_2
ANKRD13A	MSN_Drd1+_2
ANO3	MSN_Drd1+_2
AP3M1	MSN_Drd1+_2
APLP1	MSN_Drd1+_2
APOE	MSN_Drd1+_2
ARL6IP1	MSN_Drd1+_2
ARMC2	MSN_Drd1+_2
ATP1A2	MSN_Drd1+_2
ATP1B1	MSN_Drd1+_2
ATP2A2	MSN_Drd1+_2
ATP5MC3	MSN_Drd1+_2
ATP5PD	MSN_Drd1+_2
ATP5PF	MSN_Drd1+_2
ATP6AP2	MSN_Drd1+_2
ATP6V0C	MSN_Drd1+_2
ATXN7L3B	MSN_Drd1+_2
BAG1	MSN_Drd1+_2
BCAP31	MSN_Drd1+_2
BRI3	MSN_Drd1+_2
BSCL2	MSN_Drd1+_2
BTF3L4	MSN_Drd1+_2
CADM2	MSN_Drd1+_2
CADM4	MSN_Drd1+_2
CALM1	MSN_Drd1+_2
CAMK2N1	MSN_Drd1+_2
CAPZA2	MSN_Drd1+_2
CCT3	MSN_Drd1+_2
CCT7	MSN_Drd1+_2
CCT8	MSN_Drd1+_2
CD81	MSN_Drd1+_2
CDH13	MSN_Drd1+_2
CDIPT	MSN_Drd1+_2
CDK5R1	MSN_Drd1+_2
CELF3	MSN_Drd1+_2
CEND1	MSN_Drd1+_2
CHCHD2	MSN_Drd1+_2
CHIA	MSN_Drd1+_2
CISD1	MSN_Drd1+_2
CKB	MSN_Drd1+_2
CLU	MSN_Drd1+_2
CNIH2	MSN_Drd1+_2
CNTN3	MSN_Drd1+_2
CNTNAP3C	MSN_Drd1+_2
CNTNAP3B	MSN_Drd1+_2
CNTNAP3	MSN_Drd1+_2
COL11A1	MSN_Drd1+_2
COX5A	MSN_Drd1+_2
COX6C	MSN_Drd1+_2
COX7C	MSN_Drd1+_2
COX8A	MSN_Drd1+_2
CRIP2	MSN_Drd1+_2
CRYM	MSN_Drd1+_2
CSPG5	MSN_Drd1+_2
CST3	MSN_Drd1+_2
CUL1	MSN_Drd1+_2
CUTA	MSN_Drd1+_2
CYC1	MSN_Drd1+_2
CYCS	MSN_Drd1+_2
DAD1	MSN_Drd1+_2
DDX17	MSN_Drd1+_2
DDX24	MSN_Drd1+_2
DEGS1	MSN_Drd1+_2
DGKI	MSN_Drd1+_2
DNAJB11	MSN_Drd1+_2
DNAJB5	MSN_Drd1+_2
DOT1L	MSN_Drd1+_2
DPM3	MSN_Drd1+_2
DSCAM	MSN_Drd1+_2
DSCAML1	MSN_Drd1+_2
DYNLL1	MSN_Drd1+_2
EDIL3	MSN_Drd1+_2
EEF1A1	MSN_Drd1+_2
EFNB3	MSN_Drd1+_2
EIF1	MSN_Drd1+_2
EIF1B	MSN_Drd1+_2
EMC4	MSN_Drd1+_2
EMC7	MSN_Drd1+_2
EML6	MSN_Drd1+_2
ENPP5	MSN_Drd1+_2
ESD	MSN_Drd1+_2
FABP5	MSN_Drd1+_2
FAIM2	MSN_Drd1+_2
FAT3	MSN_Drd1+_2
FAU	MSN_Drd1+_2
FBXL19	MSN_Drd1+_2
FOXP1	MSN_Drd1+_2
FRMD4B	MSN_Drd1+_2
FTH1	MSN_Drd1+_2
FTL	MSN_Drd1+_2
GAA	MSN_Drd1+_2
GABARAPL1	MSN_Drd1+_2
GABRA5	MSN_Drd1+_2
GAPDH	MSN_Drd1+_2
GDE1	MSN_Drd1+_2
GHITM	MSN_Drd1+_2
GLUL	MSN_Drd1+_2
GOT1	MSN_Drd1+_2
GPCPD1	MSN_Drd1+_2
GPM6B	MSN_Drd1+_2
GPR22	MSN_Drd1+_2
GPR83	MSN_Drd1+_2
GRIA4	MSN_Drd1+_2
GRIK5	MSN_Drd1+_2
GRIP1	MSN_Drd1+_2
HECW2	MSN_Drd1+_2
HERPUD1	MSN_Drd1+_2
HNRNPA2B1	MSN_Drd1+_2
HP1BP3	MSN_Drd1+_2
HS6ST3	MSN_Drd1+_2
HSP90AA1	MSN_Drd1+_2
HSP90AB1	MSN_Drd1+_2
HSP90B1	MSN_Drd1+_2
HSPA13	MSN_Drd1+_2
HSPA8	MSN_Drd1+_2
HSPH1	MSN_Drd1+_2
HTR2C	MSN_Drd1+_2
IGSF8	MSN_Drd1+_2
ITM2B	MSN_Drd1+_2
ITM2C	MSN_Drd1+_2
JUND	MSN_Drd1+_2
KANSL1L	MSN_Drd1+_2
KBTBD11	MSN_Drd1+_2
KCNK1	MSN_Drd1+_2
KIDINS220	MSN_Drd1+_2
KIF1B	MSN_Drd1+_2
KIRREL3	MSN_Drd1+_2
LAMP1	MSN_Drd1+_2
LDLRAD4	MSN_Drd1+_2
LINGO1	MSN_Drd1+_2
LINGO2	MSN_Drd1+_2
LINGO3	MSN_Drd1+_2
LRP12	MSN_Drd1+_2
LRRK2	MSN_Drd1+_2
LRRTM4	MSN_Drd1+_2
LRTM1	MSN_Drd1+_2
LY6H	MSN_Drd1+_2
MAGED1	MSN_Drd1+_2
MAGEE1	MSN_Drd1+_2
MAML3	MSN_Drd1+_2
MAN2A2	MSN_Drd1+_2
MAP1A	MSN_Drd1+_2
MAPK4	MSN_Drd1+_2
MARCKS	MSN_Drd1+_2
MB21D2	MSN_Drd1+_2
MBP	MSN_Drd1+_2
MDH1	MSN_Drd1+_2
MFGE8	MSN_Drd1+_2
MIB1	MSN_Drd1+_2
MPC2	MSN_Drd1+_2
MRFAP1	MSN_Drd1+_2
MRFAP1L1	MSN_Drd1+_2
MRPS34	MSN_Drd1+_2
MSMO1	MSN_Drd1+_2
MSRA	MSN_Drd1+_2
MT1G	MSN_Drd1+_2
MYO1B	MSN_Drd1+_2
NACA	MSN_Drd1+_2
NAV2	MSN_Drd1+_2
NCEH1	MSN_Drd1+_2
NDRG2	MSN_Drd1+_2
NDUFA4	MSN_Drd1+_2
NDUFA5	MSN_Drd1+_2
NDUFA7	MSN_Drd1+_2
NDUFAB1	MSN_Drd1+_2
NDUFB2	MSN_Drd1+_2
NDUFB4	MSN_Drd1+_2
NDUFC2-KCTD14	MSN_Drd1+_2
NDUFC2	MSN_Drd1+_2
NDUFS2	MSN_Drd1+_2
NDUFV1	MSN_Drd1+_2
NEBL	MSN_Drd1+_2
NECAB1	MSN_Drd1+_2
NEFL	MSN_Drd1+_2
NME7	MSN_Drd1+_2
NPFFR2	MSN_Drd1+_2
NR3C1	MSN_Drd1+_2
NR4A1	MSN_Drd1+_2
NRGN	MSN_Drd1+_2
NSG1	MSN_Drd1+_2
NSUN6	MSN_Drd1+_2
NUDC	MSN_Drd1+_2
OPRM1	MSN_Drd1+_2
OSBPL8	MSN_Drd1+_2
OXR1	MSN_Drd1+_2
PAFAH1B1	MSN_Drd1+_2
PAM	MSN_Drd1+_2
PARN	MSN_Drd1+_2
PCDH11Y	MSN_Drd1+_2
PCDH11X	MSN_Drd1+_2
PCDH7	MSN_Drd1+_2
PCSK1N	MSN_Drd1+_2
PDE7B	MSN_Drd1+_2
PDIA3	MSN_Drd1+_2
PDPK1	MSN_Drd1+_2
PFDN5	MSN_Drd1+_2
PGAM4	MSN_Drd1+_2
PGAM1	MSN_Drd1+_2
PGK1	MSN_Drd1+_2
PKM	MSN_Drd1+_2
PLD5	MSN_Drd1+_2
PLP1	MSN_Drd1+_2
PNMA8A	MSN_Drd1+_2
PNMA8B	MSN_Drd1+_2
PRDX1	MSN_Drd1+_2
PRDX5	MSN_Drd1+_2
PRDX6	MSN_Drd1+_2
PRKG1	MSN_Drd1+_2
PRNP	MSN_Drd1+_2
PRR7	MSN_Drd1+_2
PSAP	MSN_Drd1+_2
PSD3	MSN_Drd1+_2
PSENEN	MSN_Drd1+_2
PSMA4	MSN_Drd1+_2
PSMD2	MSN_Drd1+_2
PTGDS	MSN_Drd1+_2
PTN	MSN_Drd1+_2
PTPRE	MSN_Drd1+_2
PTPRN	MSN_Drd1+_2
QDPR	MSN_Drd1+_2
RAB14	MSN_Drd1+_2
RAB3A	MSN_Drd1+_2
RALGAPA2	MSN_Drd1+_2
RAPGEF4	MSN_Drd1+_2
RASGEF1B	MSN_Drd1+_2
REEP5	MSN_Drd1+_2
RHOBTB2	MSN_Drd1+_2
RNF220	MSN_Drd1+_2
RPL13	MSN_Drd1+_2
RPL18	MSN_Drd1+_2
RPL18A	MSN_Drd1+_2
RPL22L1	MSN_Drd1+_2
RPL23	MSN_Drd1+_2
RPL28	MSN_Drd1+_2
RPL3	MSN_Drd1+_2
RPL30	MSN_Drd1+_2
RPN1	MSN_Drd1+_2
RPS13	MSN_Drd1+_2
RPS2	MSN_Drd1+_2
RPS20	MSN_Drd1+_2
RPS23	MSN_Drd1+_2
RPS24	MSN_Drd1+_2
RPS27	MSN_Drd1+_2
RPS3A	MSN_Drd1+_2
RPS8	MSN_Drd1+_2
RPS9	MSN_Drd1+_2
RPSAP58	MSN_Drd1+_2
RPSA	MSN_Drd1+_2
RREB1	MSN_Drd1+_2
RSF1	MSN_Drd1+_2
RSPH3	MSN_Drd1+_2
RSRP1	MSN_Drd1+_2
RXRG	MSN_Drd1+_2
SARAF	MSN_Drd1+_2
SCD	MSN_Drd1+_2
SCG2	MSN_Drd1+_2
SCG3	MSN_Drd1+_2
SEC62	MSN_Drd1+_2
SELENOF	MSN_Drd1+_2
SELENOK	MSN_Drd1+_2
SELENOW	MSN_Drd1+_2
SEMA6D	MSN_Drd1+_2
SERINC1	MSN_Drd1+_2
SEZ6L2	MSN_Drd1+_2
SHISA9	MSN_Drd1+_2
SIRPA	MSN_Drd1+_2
SIRPG	MSN_Drd1+_2
SIRPB1	MSN_Drd1+_2
SLC12A5	MSN_Drd1+_2
SLC1A2	MSN_Drd1+_2
SLC22A17	MSN_Drd1+_2
SLC25A3	MSN_Drd1+_2
SLC25A4	MSN_Drd1+_2
SLC25A5	MSN_Drd1+_2
SLC4A10	MSN_Drd1+_2
SLC8A1	MSN_Drd1+_2
SMAP1	MSN_Drd1+_2
SMDT1	MSN_Drd1+_2
SNAP47	MSN_Drd1+_2
SNW1	MSN_Drd1+_2
SOWAHA	MSN_Drd1+_2
SPARCL1	MSN_Drd1+_2
SPHKAP	MSN_Drd1+_2
SPRED1	MSN_Drd1+_2
SRRM2	MSN_Drd1+_2
SRSF6	MSN_Drd1+_2
SSU72	MSN_Drd1+_2
ST8SIA3	MSN_Drd1+_2
STMN1	MSN_Drd1+_2
STMN2	MSN_Drd1+_2
STMN3	MSN_Drd1+_2
STMN4	MSN_Drd1+_2
STRIP2	MSN_Drd1+_2
STXBP2	MSN_Drd1+_2
SUB1	MSN_Drd1+_2
SYT11	MSN_Drd1+_2
TAF1D	MSN_Drd1+_2
TCEAL3	MSN_Drd1+_2
TCEAL6	MSN_Drd1+_2
TCEAL5	MSN_Drd1+_2
TCF25	MSN_Drd1+_2
TECR	MSN_Drd1+_2
TENM2	MSN_Drd1+_2
TET2	MSN_Drd1+_2
TEX9	MSN_Drd1+_2
TGOLN2	MSN_Drd1+_2
THRA	MSN_Drd1+_2
THSD7B	MSN_Drd1+_2
TIMP2	MSN_Drd1+_2
TMED9	MSN_Drd1+_2
TMEM132A	MSN_Drd1+_2
TMEM132D	MSN_Drd1+_2
TMEM30A	MSN_Drd1+_2
TMEM47	MSN_Drd1+_2
TMEM59L	MSN_Drd1+_2
TOMM20	MSN_Drd1+_2
TPI1	MSN_Drd1+_2
TPT1	MSN_Drd1+_2
TSPAN3	MSN_Drd1+_2
TSPYL4	MSN_Drd1+_2
TUBB2A	MSN_Drd1+_2
TUBB	MSN_Drd1+_2
UBB	MSN_Drd1+_2
UBQLN2	MSN_Drd1+_2
UNC50	MSN_Drd1+_2
UQCR10	MSN_Drd1+_2
UQCRFS1	MSN_Drd1+_2
USP28	MSN_Drd1+_2
UTRN	MSN_Drd1+_2
VAMP2	MSN_Drd1+_2
VDAC2	MSN_Drd1+_2
VDAC3	MSN_Drd1+_2
VGF	MSN_Drd1+_2
XPA	MSN_Drd1+_2
YWHAB	MSN_Drd1+_2
YWHAH	MSN_Drd1+_2
ZCCHC18	MSN_Drd1+_2
ZCCHC12	MSN_Drd1+_2
ZDHHC20	MSN_Drd1+_2
ZNF397	MSN_Drd1+_2
C8orf34	MSN_Drd2+_1
ACP1	MSN_Drd2+_1
ACSL3	MSN_Drd2+_1
ACTB	MSN_Drd2+_1
ACTG1	MSN_Drd2+_1
ACTN2	MSN_Drd2+_1
ACVR1C	MSN_Drd2+_1
ADAM12	MSN_Drd2+_1
ADK	MSN_Drd2+_1
AFF3	MSN_Drd2+_1
AHI1	MSN_Drd2+_1
ALDOA	MSN_Drd2+_1
ANO3	MSN_Drd2+_1
APLP1	MSN_Drd2+_1
ARHGAP6	MSN_Drd2+_1
ARL15	MSN_Drd2+_1
ARL6IP1	MSN_Drd2+_1
ATP1A1	MSN_Drd2+_1
ATP1B1	MSN_Drd2+_1
ATP2A2	MSN_Drd2+_1
ATP5F1B	MSN_Drd2+_1
ATP5MC3	MSN_Drd2+_1
ATP5PD	MSN_Drd2+_1
ATP5PF	MSN_Drd2+_1
ATP6AP2	MSN_Drd2+_1
ATP6V0C	MSN_Drd2+_1
ATP6V1D	MSN_Drd2+_1
ATP6V1E1	MSN_Drd2+_1
ATXN7L3B	MSN_Drd2+_1
BEX2	MSN_Drd2+_1
BEX1	MSN_Drd2+_1
C1QTNF4	MSN_Drd2+_1
CACNA1H	MSN_Drd2+_1
CALM1	MSN_Drd2+_1
CAPZA2	MSN_Drd2+_1
CA12	MSN_Drd2+_1
CCT2	MSN_Drd2+_1
CCT5	MSN_Drd2+_1
CCT7	MSN_Drd2+_1
CCT8	MSN_Drd2+_1
CDIPT	MSN_Drd2+_1
CDK5R1	MSN_Drd2+_1
CELF3	MSN_Drd2+_1
CHCHD10	MSN_Drd2+_1
CHCHD2	MSN_Drd2+_1
CHRM3	MSN_Drd2+_1
CISD1	MSN_Drd2+_1
CKB	MSN_Drd2+_1
CLTC	MSN_Drd2+_1
CMSS1	MSN_Drd2+_1
CNTN4	MSN_Drd2+_1
CNTN5	MSN_Drd2+_1
COX5A	MSN_Drd2+_1
COX6C	MSN_Drd2+_1
COX8A	MSN_Drd2+_1
CPNE4	MSN_Drd2+_1
CPNE5	MSN_Drd2+_1
CROCC	MSN_Drd2+_1
CSPG5	MSN_Drd2+_1
CYP46A1	MSN_Drd2+_1
DAD1	MSN_Drd2+_1
DGKI	MSN_Drd2+_1
DHX36	MSN_Drd2+_1
DNAJB11	MSN_Drd2+_1
DNER	MSN_Drd2+_1
DUSP14	MSN_Drd2+_1
EEF1A1	MSN_Drd2+_1
EEF1A2	MSN_Drd2+_1
EIF1	MSN_Drd2+_1
EIF3CL	MSN_Drd2+_1
EIF3C	MSN_Drd2+_1
ELL2	MSN_Drd2+_1
EMC7	MSN_Drd2+_1
ENC1	MSN_Drd2+_1
EPB41	MSN_Drd2+_1
NALF1	MSN_Drd2+_1
FAU	MSN_Drd2+_1
FGF10	MSN_Drd2+_1
FIG4	MSN_Drd2+_1
FKBP1A	MSN_Drd2+_1
FKBP1C	MSN_Drd2+_1
FRMD4B	MSN_Drd2+_1
FTH1	MSN_Drd2+_1
GAA	MSN_Drd2+_1
GALNTL6	MSN_Drd2+_1
GAPDH	MSN_Drd2+_1
GAREM1	MSN_Drd2+_1
GDE1	MSN_Drd2+_1
GHITM	MSN_Drd2+_1
GKAP1	MSN_Drd2+_1
GOT1	MSN_Drd2+_1
GPCPD1	MSN_Drd2+_1
GPM6B	MSN_Drd2+_1
GPR27	MSN_Drd2+_1
GPR88	MSN_Drd2+_1
GPRASP1	MSN_Drd2+_1
GREB1L	MSN_Drd2+_1
GRM1	MSN_Drd2+_1
H3-5	MSN_Drd2+_1
H3-3B	MSN_Drd2+_1
HSP90AA1	MSN_Drd2+_1
HSP90AB1	MSN_Drd2+_1
HSP90B1	MSN_Drd2+_1
HSPA5	MSN_Drd2+_1
HSPA8	MSN_Drd2+_1
HTR4	MSN_Drd2+_1
IGSF8	MSN_Drd2+_1
INPP4B	MSN_Drd2+_1
ITM2B	MSN_Drd2+_1
ITM2C	MSN_Drd2+_1
ITPR1	MSN_Drd2+_1
KBTBD11	MSN_Drd2+_1
KCNH7	MSN_Drd2+_1
KCNK1	MSN_Drd2+_1
KIF1A	MSN_Drd2+_1
KIF5C	MSN_Drd2+_1
KIFAP3	MSN_Drd2+_1
LAMP1	MSN_Drd2+_1
LDLRAD4	MSN_Drd2+_1
LINGO2	MSN_Drd2+_1
LRTM1	MSN_Drd2+_1
LSAMP	MSN_Drd2+_1
LY6H	MSN_Drd2+_1
MAGEE1	MSN_Drd2+_1
MAPK4	MSN_Drd2+_1
MARCKS	MSN_Drd2+_1
MCTP1	MSN_Drd2+_1
MDH1	MSN_Drd2+_1
MIF	MSN_Drd2+_1
MORF4L1	MSN_Drd2+_1
MT1G	MSN_Drd2+_1
NCDN	MSN_Drd2+_1
NDUFA4	MSN_Drd2+_1
NDUFAB1	MSN_Drd2+_1
NDUFC2-KCTD14	MSN_Drd2+_1
NDUFC2	MSN_Drd2+_1
NDUFS5	MSN_Drd2+_1
NEDD4	MSN_Drd2+_1
NME1	MSN_Drd2+_1
NME7	MSN_Drd2+_1
NRG1	MSN_Drd2+_1
NSG1	MSN_Drd2+_1
NTM	MSN_Drd2+_1
NTNG1	MSN_Drd2+_1
OGT	MSN_Drd2+_1
PAFAH1B1	MSN_Drd2+_1
PBX3	MSN_Drd2+_1
PCDH15	MSN_Drd2+_1
PCDH17	MSN_Drd2+_1
PCDH9	MSN_Drd2+_1
PCSK1N	MSN_Drd2+_1
PDE1A	MSN_Drd2+_1
PDE7B	MSN_Drd2+_1
PDIA3	MSN_Drd2+_1
PDIA6	MSN_Drd2+_1
PENK	MSN_Drd2+_1
PFDN5	MSN_Drd2+_1
PGAM4	MSN_Drd2+_1
PGAM1	MSN_Drd2+_1
PGK1	MSN_Drd2+_1
PGRMC1	MSN_Drd2+_1
PKM	MSN_Drd2+_1
PNMA8B	MSN_Drd2+_1
PRDX6	MSN_Drd2+_1
PREX2	MSN_Drd2+_1
PRKD1	MSN_Drd2+_1
PRNP	MSN_Drd2+_1
PRR16	MSN_Drd2+_1
PSAP	MSN_Drd2+_1
PSMC5	MSN_Drd2+_1
PTN	MSN_Drd2+_1
PURB	MSN_Drd2+_1
RAB14	MSN_Drd2+_1
RAB3A	MSN_Drd2+_1
RAB6B	MSN_Drd2+_1
RALYL	MSN_Drd2+_1
REEP5	MSN_Drd2+_1
RELN	MSN_Drd2+_1
ROBO1	MSN_Drd2+_1
RPL13	MSN_Drd2+_1
RPL18A	MSN_Drd2+_1
RPL19	MSN_Drd2+_1
RPL22L1	MSN_Drd2+_1
RPL23	MSN_Drd2+_1
RPL28	MSN_Drd2+_1
RPL3	MSN_Drd2+_1
RPL30	MSN_Drd2+_1
RPL35A	MSN_Drd2+_1
RPL8	MSN_Drd2+_1
RPN1	MSN_Drd2+_1
RPS11	MSN_Drd2+_1
RPS21	MSN_Drd2+_1
RPS23	MSN_Drd2+_1
RPS3A	MSN_Drd2+_1
RPS4X	MSN_Drd2+_1
RPS8	MSN_Drd2+_1
RPSAP58	MSN_Drd2+_1
RPSA	MSN_Drd2+_1
RSRP1	MSN_Drd2+_1
RTN1	MSN_Drd2+_1
RTN4	MSN_Drd2+_1
SARAF	MSN_Drd2+_1
SCG2	MSN_Drd2+_1
SEC62	MSN_Drd2+_1
SELENOF	MSN_Drd2+_1
SELENOK	MSN_Drd2+_1
SERINC1	MSN_Drd2+_1
SERTAD2	MSN_Drd2+_1
SLC25A4	MSN_Drd2+_1
SLC25A5	MSN_Drd2+_1
SLC32A1	MSN_Drd2+_1
SLC35F4	MSN_Drd2+_1
SLC4A4	MSN_Drd2+_1
SLC8A1	MSN_Drd2+_1
SLIT3	MSN_Drd2+_1
SRRM2	MSN_Drd2+_1
STK31	MSN_Drd2+_1
STMN3	MSN_Drd2+_1
SYP	MSN_Drd2+_1
SYT11	MSN_Drd2+_1
TAC1	MSN_Drd2+_1
TAF1D	MSN_Drd2+_1
TAGLN3	MSN_Drd2+_1
TBC1D8	MSN_Drd2+_1
TCF4	MSN_Drd2+_1
TECR	MSN_Drd2+_1
TGOLN2	MSN_Drd2+_1
THSD7A	MSN_Drd2+_1
THSD7B	MSN_Drd2+_1
TIMP2	MSN_Drd2+_1
TKT	MSN_Drd2+_1
TM9SF3	MSN_Drd2+_1
TMEM132A	MSN_Drd2+_1
TMEM30A	MSN_Drd2+_1
TMEM59L	MSN_Drd2+_1
TMSB4Y	MSN_Drd2+_1
TNKS2	MSN_Drd2+_1
TOMM20	MSN_Drd2+_1
TPT1	MSN_Drd2+_1
TSPYL4	MSN_Drd2+_1
TUBA1A	MSN_Drd2+_1
TUBB2A	MSN_Drd2+_1
TUBB3	MSN_Drd2+_1
TUBB	MSN_Drd2+_1
UBB	MSN_Drd2+_1
UBC	MSN_Drd2+_1
UBQLN2	MSN_Drd2+_1
UCHL1	MSN_Drd2+_1
UNC50	MSN_Drd2+_1
UNC5D	MSN_Drd2+_1
UQCRFS1	MSN_Drd2+_1
VAMP2	MSN_Drd2+_1
VDAC3	MSN_Drd2+_1
VSNL1	MSN_Drd2+_1
WFS1	MSN_Drd2+_1
YWHAB	MSN_Drd2+_1
ZC3H15	MSN_Drd2+_1
ZNF804B	MSN_Drd2+_1
ACTB	MSN_Drd2+_2
ACTN4	MSN_Drd2+_2
ADCY1	MSN_Drd2+_2
AHI1	MSN_Drd2+_2
AKR7L	MSN_Drd2+_2
ARL6IP1	MSN_Drd2+_2
ATP2A2	MSN_Drd2+_2
ATP5MC3	MSN_Drd2+_2
CALB1	MSN_Drd2+_2
CALM2	MSN_Drd2+_2
CD81	MSN_Drd2+_2
CDIPT	MSN_Drd2+_2
CLK1	MSN_Drd2+_2
CTSZ	MSN_Drd2+_2
DNAJB11	MSN_Drd2+_2
DYNLL1	MSN_Drd2+_2
EIF1	MSN_Drd2+_2
EMC7	MSN_Drd2+_2
FAU	MSN_Drd2+_2
FSD1L	MSN_Drd2+_2
FTH1	MSN_Drd2+_2
GAA	MSN_Drd2+_2
GDE1	MSN_Drd2+_2
GHITM	MSN_Drd2+_2
GPR162	MSN_Drd2+_2
HS6ST3	MSN_Drd2+_2
HSP90AA1	MSN_Drd2+_2
HSP90AB1	MSN_Drd2+_2
HSPA8	MSN_Drd2+_2
IRAK1	MSN_Drd2+_2
ITM2B	MSN_Drd2+_2
LAMP1	MSN_Drd2+_2
LCOR	MSN_Drd2+_2
MGAT2	MSN_Drd2+_2
NALCN	MSN_Drd2+_2
NDUFA7	MSN_Drd2+_2
PARD6G	MSN_Drd2+_2
PCSK1N	MSN_Drd2+_2
PDIA3	MSN_Drd2+_2
PFDN5	MSN_Drd2+_2
PGK1	MSN_Drd2+_2
PRNP	MSN_Drd2+_2
PTN	MSN_Drd2+_2
PTPRT	MSN_Drd2+_2
REEP5	MSN_Drd2+_2
RELCH	MSN_Drd2+_2
RGS4	MSN_Drd2+_2
RPL18	MSN_Drd2+_2
RPL22L1	MSN_Drd2+_2
RPL28	MSN_Drd2+_2
RPS8	MSN_Drd2+_2
SCD	MSN_Drd2+_2
SCG2	MSN_Drd2+_2
SELENOK	MSN_Drd2+_2
SLC1A2	MSN_Drd2+_2
STMN1	MSN_Drd2+_2
SYT11	MSN_Drd2+_2
TECR	MSN_Drd2+_2
TIMP2	MSN_Drd2+_2
TM2D2	MSN_Drd2+_2
TMEM132A	MSN_Drd2+_2
TMEM30A	MSN_Drd2+_2
UBB	MSN_Drd2+_2
UQCR10	MSN_Drd2+_2
UQCRFS1	MSN_Drd2+_2
AKAP5	MSN_Drd3+_1
APLP1	MSN_Drd3+_1
ARL6IP1	MSN_Drd3+_1
ATP2A2	MSN_Drd3+_1
CD81	MSN_Drd3+_1
COX7C	MSN_Drd3+_1
CST3	MSN_Drd3+_1
FSTL4	MSN_Drd3+_1
FTH1	MSN_Drd3+_1
GRID2	MSN_Drd3+_1
HSP90B1	MSN_Drd3+_1
ITM2B	MSN_Drd3+_1
KCNK1	MSN_Drd3+_1
LAMP1	MSN_Drd3+_1
NRG3	MSN_Drd3+_1
PLP1	MSN_Drd3+_1
PSAP	MSN_Drd3+_1
RPN1	MSN_Drd3+_1
RPS27	MSN_Drd3+_1
RTN1	MSN_Drd3+_1
SARAF	MSN_Drd3+_1
SELENOF	MSN_Drd3+_1
TIMM8B	MSN_Drd3+_1
TIMP2	MSN_Drd3+_1
UQCRQ	MSN_Drd3+_1
C16orf72	MSN_Grm8+_1
C8orf34	MSN_Grm8+_1
ABHD17A	MSN_Grm8+_1
ABLIM1	MSN_Grm8+_1
ACSL3	MSN_Grm8+_1
ACSL6	MSN_Grm8+_1
ACVR1C	MSN_Grm8+_1
ADGRB1	MSN_Grm8+_1
ADPRH	MSN_Grm8+_1
ANKFN1	MSN_Grm8+_1
APLP1	MSN_Grm8+_1
APOE	MSN_Grm8+_1
ARL6IP1	MSN_Grm8+_1
ARPP19	MSN_Grm8+_1
ASTN2	MSN_Grm8+_1
ATP1A1	MSN_Grm8+_1
ATP1B1	MSN_Grm8+_1
ATP1B2	MSN_Grm8+_1
ATP2A2	MSN_Grm8+_1
ATP2B1	MSN_Grm8+_1
ATP5MC3	MSN_Grm8+_1
ATXN7L3B	MSN_Grm8+_1
BTF3	MSN_Grm8+_1
C1QTNF12	MSN_Grm8+_1
CACNA1A	MSN_Grm8+_1
CADM2	MSN_Grm8+_1
CBARP	MSN_Grm8+_1
CCNL1	MSN_Grm8+_1
CCT7	MSN_Grm8+_1
CD81	MSN_Grm8+_1
CELF3	MSN_Grm8+_1
CISD1	MSN_Grm8+_1
CLU	MSN_Grm8+_1
CNIH2	MSN_Grm8+_1
COX7C	MSN_Grm8+_1
CRTAC1	MSN_Grm8+_1
CRYBG1	MSN_Grm8+_1
CRYM	MSN_Grm8+_1
CSPG5	MSN_Grm8+_1
CST3	MSN_Grm8+_1
CTSB	MSN_Grm8+_1
DAD1	MSN_Grm8+_1
DBP	MSN_Grm8+_1
DCTN3	MSN_Grm8+_1
DGKI	MSN_Grm8+_1
DLK2	MSN_Grm8+_1
DNAJB11	MSN_Grm8+_1
EEF1A2	MSN_Grm8+_1
EMC6	MSN_Grm8+_1
EML5	MSN_Grm8+_1
ENC1	MSN_Grm8+_1
FAM135B	MSN_Grm8+_1
FAU	MSN_Grm8+_1
FBLL1	MSN_Grm8+_1
FHL2	MSN_Grm8+_1
FTH1	MSN_Grm8+_1
GAA	MSN_Grm8+_1
GALNT9	MSN_Grm8+_1
GAS1	MSN_Grm8+_1
GDE1	MSN_Grm8+_1
GLUL	MSN_Grm8+_1
GPC6	MSN_Grm8+_1
GPR162	MSN_Grm8+_1
GPRASP1	MSN_Grm8+_1
GRIA3	MSN_Grm8+_1
GRIA4	MSN_Grm8+_1
GRIK2	MSN_Grm8+_1
GRM5	MSN_Grm8+_1
GSAP	MSN_Grm8+_1
HIVEP2	MSN_Grm8+_1
HSP90AA1	MSN_Grm8+_1
HSP90AB1	MSN_Grm8+_1
HSP90B1	MSN_Grm8+_1
IMPACT	MSN_Grm8+_1
ITM2B	MSN_Grm8+_1
KCNJ9	MSN_Grm8+_1
KCNK1	MSN_Grm8+_1
KITLG	MSN_Grm8+_1
LACTB	MSN_Grm8+_1
LAMP1	MSN_Grm8+_1
LINGO1	MSN_Grm8+_1
MACROD2	MSN_Grm8+_1
MAGEE1	MSN_Grm8+_1
MAML3	MSN_Grm8+_1
MAP4K2	MSN_Grm8+_1
MAPK4	MSN_Grm8+_1
MEF2C	MSN_Grm8+_1
MRPL20	MSN_Grm8+_1
MSMO1	MSN_Grm8+_1
MT1G	MSN_Grm8+_1
MYCBP2	MSN_Grm8+_1
NDRG2	MSN_Grm8+_1
NDUFA7	MSN_Grm8+_1
NDUFB4	MSN_Grm8+_1
NDUFC2-KCTD14	MSN_Grm8+_1
NDUFC2	MSN_Grm8+_1
NEBL	MSN_Grm8+_1
NENF	MSN_Grm8+_1
NFIB	MSN_Grm8+_1
NLGN1	MSN_Grm8+_1
NPTX1	MSN_Grm8+_1
NSMCE4A	MSN_Grm8+_1
ODR4	MSN_Grm8+_1
PAPPA	MSN_Grm8+_1
PCBP1	MSN_Grm8+_1
PCDH17	MSN_Grm8+_1
PCSK1N	MSN_Grm8+_1
PDIA3	MSN_Grm8+_1
PDIA6	MSN_Grm8+_1
PENK	MSN_Grm8+_1
PGRMC1	MSN_Grm8+_1
PIGY	MSN_Grm8+_1
PLK2	MSN_Grm8+_1
PLPP3	MSN_Grm8+_1
PMM1	MSN_Grm8+_1
PNMA8A	MSN_Grm8+_1
PRDX5	MSN_Grm8+_1
PRKG1	MSN_Grm8+_1
PRKN	MSN_Grm8+_1
PRNP	MSN_Grm8+_1
PRPF4B	MSN_Grm8+_1
PSAP	MSN_Grm8+_1
PSMA4	MSN_Grm8+_1
PSMB5	MSN_Grm8+_1
PTN	MSN_Grm8+_1
PTPN12	MSN_Grm8+_1
PTPRM	MSN_Grm8+_1
PTPRN	MSN_Grm8+_1
RACK1	MSN_Grm8+_1
RBMS3	MSN_Grm8+_1
RER1	MSN_Grm8+_1
RERG	MSN_Grm8+_1
RND3	MSN_Grm8+_1
RPL14	MSN_Grm8+_1
RPL22L1	MSN_Grm8+_1
RPL27A	MSN_Grm8+_1
RPL28	MSN_Grm8+_1
RPL29	MSN_Grm8+_1
RPL35	MSN_Grm8+_1
RPL8	MSN_Grm8+_1
RPS26	MSN_Grm8+_1
RPS27	MSN_Grm8+_1
RPS8	MSN_Grm8+_1
RPSAP58	MSN_Grm8+_1
RPSA	MSN_Grm8+_1
RSPO3	MSN_Grm8+_1
RTN1	MSN_Grm8+_1
SARAF	MSN_Grm8+_1
SCD	MSN_Grm8+_1
SCG2	MSN_Grm8+_1
SELENOF	MSN_Grm8+_1
SELENOW	MSN_Grm8+_1
SERINC1	MSN_Grm8+_1
SESN3	MSN_Grm8+_1
SGCD	MSN_Grm8+_1
SGIP1	MSN_Grm8+_1
SKIDA1	MSN_Grm8+_1
SLC16A2	MSN_Grm8+_1
SLC1A2	MSN_Grm8+_1
SLC25A4	MSN_Grm8+_1
SMDT1	MSN_Grm8+_1
SPARCL1	MSN_Grm8+_1
SPCS1	MSN_Grm8+_1
SQLE	MSN_Grm8+_1
ST3GAL5	MSN_Grm8+_1
ST8SIA3	MSN_Grm8+_1
STMN1	MSN_Grm8+_1
STMN3	MSN_Grm8+_1
SYT11	MSN_Grm8+_1
SYT4	MSN_Grm8+_1
TGOLN2	MSN_Grm8+_1
TIMM8B	MSN_Grm8+_1
TIMP2	MSN_Grm8+_1
TM2D2	MSN_Grm8+_1
TMEM101	MSN_Grm8+_1
TMEM132A	MSN_Grm8+_1
TMEM30A	MSN_Grm8+_1
TOMM70	MSN_Grm8+_1
TPCN1	MSN_Grm8+_1
TPI1	MSN_Grm8+_1
TRPC3	MSN_Grm8+_1
TUBA1A	MSN_Grm8+_1
TUBA1B	MSN_Grm8+_1
TUBB2A	MSN_Grm8+_1
TUBB	MSN_Grm8+_1
UBXN2A	MSN_Grm8+_1
UNC5D	MSN_Grm8+_1
UQCR10	MSN_Grm8+_1
UQCRQ	MSN_Grm8+_1
VAMP2	MSN_Grm8+_1
VGF	MSN_Grm8+_1
VWC2L	MSN_Grm8+_1
WDR83OS	MSN_Grm8+_1
WFS1	MSN_Grm8+_1
XYLT1	MSN_Grm8+_1
ZFPM2	MSN_Grm8+_1
ABLIM2	MSN_Grm8+_2
ABR	MSN_Grm8+_2
ALCAM	MSN_Grm8+_2
ANO3	MSN_Grm8+_2
ANO4	MSN_Grm8+_2
ARL6IP1	MSN_Grm8+_2
ARPC4	MSN_Grm8+_2
ASIC4	MSN_Grm8+_2
ATP1B1	MSN_Grm8+_2
ATP2B1	MSN_Grm8+_2
AURKAIP1	MSN_Grm8+_2
B4GALNT4	MSN_Grm8+_2
C1QTNF4	MSN_Grm8+_2
CACNA2D2	MSN_Grm8+_2
CADM2	MSN_Grm8+_2
CBX6	MSN_Grm8+_2
CD81	MSN_Grm8+_2
CHN1	MSN_Grm8+_2
CLEC2D	MSN_Grm8+_2
CNPY2	MSN_Grm8+_2
CNR1	MSN_Grm8+_2
CNTN3	MSN_Grm8+_2
CNTN5	MSN_Grm8+_2
COBLL1	MSN_Grm8+_2
CPA6	MSN_Grm8+_2
CRTAP	MSN_Grm8+_2
CSMD1	MSN_Grm8+_2
CTNNA3	MSN_Grm8+_2
CYLD	MSN_Grm8+_2
DCHS2	MSN_Grm8+_2
DGKG	MSN_Grm8+_2
DIP2B	MSN_Grm8+_2
DLGAP1	MSN_Grm8+_2
DOCK10	MSN_Grm8+_2
DYNC1I1	MSN_Grm8+_2
EDARADD	MSN_Grm8+_2
EML5	MSN_Grm8+_2
EYA2	MSN_Grm8+_2
NALF1	MSN_Grm8+_2
FTH1	MSN_Grm8+_2
GAA	MSN_Grm8+_2
GALNTL6	MSN_Grm8+_2
GARNL3	MSN_Grm8+_2
GDI1	MSN_Grm8+_2
GLUL	MSN_Grm8+_2
GNG2	MSN_Grm8+_2
GPM6B	MSN_Grm8+_2
GPR137	MSN_Grm8+_2
GPRC5B	MSN_Grm8+_2
GRIP1	MSN_Grm8+_2
GRM7	MSN_Grm8+_2
HCN1	MSN_Grm8+_2
HDAC9	MSN_Grm8+_2
HIVEP2	MSN_Grm8+_2
HS3ST4	MSN_Grm8+_2
HSP90AB1	MSN_Grm8+_2
HSPA5	MSN_Grm8+_2
KCNQ5	MSN_Grm8+_2
KHDRBS2	MSN_Grm8+_2
KIDINS220	MSN_Grm8+_2
KIF5C	MSN_Grm8+_2
KLF5	MSN_Grm8+_2
KRTCAP2	MSN_Grm8+_2
L1CAM	MSN_Grm8+_2
LCORL	MSN_Grm8+_2
LDLRAD4	MSN_Grm8+_2
LGI3	MSN_Grm8+_2
LGR6	MSN_Grm8+_2
LRRC4C	MSN_Grm8+_2
LRRTM3	MSN_Grm8+_2
LSAMP	MSN_Grm8+_2
LY6H	MSN_Grm8+_2
MACROD2	MSN_Grm8+_2
MAP1B	MSN_Grm8+_2
MDGA1	MSN_Grm8+_2
MESD	MSN_Grm8+_2
MGAT4C	MSN_Grm8+_2
MPND	MSN_Grm8+_2
MPPED1	MSN_Grm8+_2
MPRIP	MSN_Grm8+_2
NAV1	MSN_Grm8+_2
NELL2	MSN_Grm8+_2
NTM	MSN_Grm8+_2
OPCML	MSN_Grm8+_2
OPRL1	MSN_Grm8+_2
PCDH15	MSN_Grm8+_2
PDE4B	MSN_Grm8+_2
PHACTR1	MSN_Grm8+_2
PLCB4	MSN_Grm8+_2
PLXNA4	MSN_Grm8+_2
PLXNC1	MSN_Grm8+_2
PPARG	MSN_Grm8+_2
PRKAR1A	MSN_Grm8+_2
PSME1	MSN_Grm8+_2
PTN	MSN_Grm8+_2
RALGAPA2	MSN_Grm8+_2
RAP1GAP	MSN_Grm8+_2
RDH14	MSN_Grm8+_2
RGS9	MSN_Grm8+_2
RNF112	MSN_Grm8+_2
ROBO1	MSN_Grm8+_2
ROBO2	MSN_Grm8+_2
ROR2	MSN_Grm8+_2
RTN1	MSN_Grm8+_2
SDC3	MSN_Grm8+_2
SDK2	MSN_Grm8+_2
SGCD	MSN_Grm8+_2
SHTN1	MSN_Grm8+_2
SLC1A2	MSN_Grm8+_2
SLC26A4	MSN_Grm8+_2
SLC6A1	MSN_Grm8+_2
SMPD3	MSN_Grm8+_2
SNX29	MSN_Grm8+_2
SORCS3	MSN_Grm8+_2
SPOCK1	MSN_Grm8+_2
SPOCK3	MSN_Grm8+_2
STARD3	MSN_Grm8+_2
STMN2	MSN_Grm8+_2
SURF4	MSN_Grm8+_2
SYT1	MSN_Grm8+_2
SYT11	MSN_Grm8+_2
TAPBP	MSN_Grm8+_2
TENM4	MSN_Grm8+_2
TM9SF2	MSN_Grm8+_2
TM9SF3	MSN_Grm8+_2
TMED9	MSN_Grm8+_2
TMEM178B	MSN_Grm8+_2
TMEM30A	MSN_Grm8+_2
TUBB	MSN_Grm8+_2
UNC5C	MSN_Grm8+_2
VPS28	MSN_Grm8+_2
YIPF1	MSN_Grm8+_2
ZNF804B	MSN_Grm8+_2
PHACTR1	Neuroblast
NCBP2AS2	Oligodendrocytes
C19orf81	Oligodendrocytes
C2orf88	Oligodendrocytes
C4orf3	Oligodendrocytes
C1orf35	Oligodendrocytes
KIAA0100	Oligodendrocytes
C16orf87	Oligodendrocytes
C1orf216	Oligodendrocytes
AAK1	Oligodendrocytes
AATK	Oligodendrocytes
ABHD16A	Oligodendrocytes
ACACA	Oligodendrocytes
ACSL4	Oligodendrocytes
ACTB	Oligodendrocytes
AGFG2	Oligodendrocytes
AGPAT5	Oligodendrocytes
AHDC1	Oligodendrocytes
TAF9	Oligodendrocytes
AKAP1	Oligodendrocytes
AKAP11	Oligodendrocytes
ALDH7A1	Oligodendrocytes
ALG5	Oligodendrocytes
ALKBH6	Oligodendrocytes
ANAPC7	Oligodendrocytes
ANKRD24	Oligodendrocytes
ANKRD50	Oligodendrocytes
ANP32D	Oligodendrocytes
ANP32A	Oligodendrocytes
ANP32B	Oligodendrocytes
AP2S1	Oligodendrocytes
APOE	Oligodendrocytes
APP	Oligodendrocytes
ARL17B	Oligodendrocytes
ARL17A	Oligodendrocytes
ARHGDIA	Oligodendrocytes
ARHGEF40	Oligodendrocytes
ARID4A	Oligodendrocytes
ARL15	Oligodendrocytes
ARL3	Oligodendrocytes
ARRDC3	Oligodendrocytes
ARSG	Oligodendrocytes
ASB13	Oligodendrocytes
ATF4	Oligodendrocytes
ATL2	Oligodendrocytes
ATN1	Oligodendrocytes
ATP5F1C	Oligodendrocytes
ATP6V1C1	Oligodendrocytes
ATP6V1G1	Oligodendrocytes
ATRAID	Oligodendrocytes
ATXN1	Oligodendrocytes
ATXN10	Oligodendrocytes
ATXN7L3B	Oligodendrocytes
AZIN1	Oligodendrocytes
B2M	Oligodendrocytes
B3GAT1	Oligodendrocytes
B4GALT3	Oligodendrocytes
BAX	Oligodendrocytes
BBS4	Oligodendrocytes
BFSP2	Oligodendrocytes
BLOC1S4	Oligodendrocytes
BRSK1	Oligodendrocytes
BTBD2	Oligodendrocytes
BTF3	Oligodendrocytes
BYSL	Oligodendrocytes
C1GALT1C1	Oligodendrocytes
CACNA2D1	Oligodendrocytes
CAMK1	Oligodendrocytes
CANX	Oligodendrocytes
CAPN10	Oligodendrocytes
CA2	Oligodendrocytes
CARS1	Oligodendrocytes
CASD1	Oligodendrocytes
CASTOR2	Oligodendrocytes
CBR4	Oligodendrocytes
CBY1	Oligodendrocytes
CCDC106	Oligodendrocytes
CCDC157	Oligodendrocytes
CCT3	Oligodendrocytes
CD47	Oligodendrocytes
CD81	Oligodendrocytes
CDH2	Oligodendrocytes
CDK17	Oligodendrocytes
CDK8	Oligodendrocytes
CEBPD	Oligodendrocytes
CFAP20	Oligodendrocytes
CHAMP1	Oligodendrocytes
CHCHD5	Oligodendrocytes
CHMP2B	Oligodendrocytes
CHMP5	Oligodendrocytes
CHSY3	Oligodendrocytes
CMAS	Oligodendrocytes
COA5	Oligodendrocytes
COA6	Oligodendrocytes
COMMD1	Oligodendrocytes
COMMD4	Oligodendrocytes
COMT	Oligodendrocytes
COPB2	Oligodendrocytes
COPS4	Oligodendrocytes
COQ7	Oligodendrocytes
COX17	Oligodendrocytes
COX20	Oligodendrocytes
COX6C	Oligodendrocytes
CPSF2	Oligodendrocytes
CREB5	Oligodendrocytes
CRYAB	Oligodendrocytes
CSNK1E	Oligodendrocytes
TPTEP2-CSNK1E	Oligodendrocytes
CSRNP3	Oligodendrocytes
CYP2U1	Oligodendrocytes
CYREN	Oligodendrocytes
CYTH2	Oligodendrocytes
DAP3	Oligodendrocytes
DCAF7	Oligodendrocytes
DCLK2	Oligodendrocytes
DCUN1D5	Oligodendrocytes
DDX6	Oligodendrocytes
DIAPH1	Oligodendrocytes
DMD	Oligodendrocytes
DNAJB1	Oligodendrocytes
DNAJB14	Oligodendrocytes
DNAJC27	Oligodendrocytes
DNAJC5	Oligodendrocytes
DRAP1	Oligodendrocytes
DRG2	Oligodendrocytes
DTD1	Oligodendrocytes
DUS1L	Oligodendrocytes
DUSP8	Oligodendrocytes
DYNC1I1	Oligodendrocytes
DYNLRB1	Oligodendrocytes
EEF1D	Oligodendrocytes
EI24	Oligodendrocytes
EIF1AX	Oligodendrocytes
EIF3L	Oligodendrocytes
EIF6	Oligodendrocytes
EMC3	Oligodendrocytes
EMC7	Oligodendrocytes
EMC9	Oligodendrocytes
ENAH	Oligodendrocytes
EPDR1	Oligodendrocytes
EPHA4	Oligodendrocytes
ERGIC1	Oligodendrocytes
ETAA1	Oligodendrocytes
FAM104B	Oligodendrocytes
FAM229B	Oligodendrocytes
FAM8A1	Oligodendrocytes
FBF1	Oligodendrocytes
FBXO22	Oligodendrocytes
FBXO31	Oligodendrocytes
FBXW12	Oligodendrocytes
FBXW7	Oligodendrocytes
FDX1	Oligodendrocytes
FGD3	Oligodendrocytes
FIS1	Oligodendrocytes
FKBP4	Oligodendrocytes
FNBP1	Oligodendrocytes
FOXP1	Oligodendrocytes
FRY	Oligodendrocytes
FTH1	Oligodendrocytes
FTL	Oligodendrocytes
FUZ	Oligodendrocytes
G3BP1	Oligodendrocytes
GABARAP	Oligodendrocytes
GABBR1	Oligodendrocytes
GARS1	Oligodendrocytes
GDE1	Oligodendrocytes
GFM1	Oligodendrocytes
GGT7	Oligodendrocytes
GMPS	Oligodendrocytes
GNG7	Oligodendrocytes
GOLGB1	Oligodendrocytes
GPR89B	Oligodendrocytes
GPR89A	Oligodendrocytes
GPS1	Oligodendrocytes
GPX4	Oligodendrocytes
GRAMD1A	Oligodendrocytes
GRAMD1B	Oligodendrocytes
GRIPAP1	Oligodendrocytes
GRM8	Oligodendrocytes
GRSF1	Oligodendrocytes
GTF2IRD1	Oligodendrocytes
HM13	Oligodendrocytes
HLA-E	Oligodendrocytes
HAGH	Oligodendrocytes
HARS2	Oligodendrocytes
HCN2	Oligodendrocytes
HDAC3	Oligodendrocytes
HECW2	Oligodendrocytes
HELZ	Oligodendrocytes
HEXD	Oligodendrocytes
HIGD1A	Oligodendrocytes
HMGCLL1	Oligodendrocytes
HMGCS1	Oligodendrocytes
HMGN3	Oligodendrocytes
HP1BP3	Oligodendrocytes
HSP90B1	Oligodendrocytes
HSPA4	Oligodendrocytes
HSPA4L	Oligodendrocytes
HSPA9	Oligodendrocytes
HSPBP1	Oligodendrocytes
HUWE1	Oligodendrocytes
IDH2	Oligodendrocytes
IDH3B	Oligodendrocytes
IFT57	Oligodendrocytes
ILF3	Oligodendrocytes
ITGB1BP1	Oligodendrocytes
ITM2B	Oligodendrocytes
ITPA	Oligodendrocytes
KAT5	Oligodendrocytes
KIFC1	Oligodendrocytes
KLHDC1	Oligodendrocytes
KLHDC4	Oligodendrocytes
KLHL11	Oligodendrocytes
KLHL13	Oligodendrocytes
KLHL22	Oligodendrocytes
KPNA1	Oligodendrocytes
LAMTOR5	Oligodendrocytes
LANCL1	Oligodendrocytes
LARS2	Oligodendrocytes
LLPH	Oligodendrocytes
LRRC40	Oligodendrocytes
LRRC45	Oligodendrocytes
LSM4	Oligodendrocytes
LSM6	Oligodendrocytes
LSM7	Oligodendrocytes
LYST	Oligodendrocytes
MACROD1	Oligodendrocytes
MACROD2	Oligodendrocytes
MAL	Oligodendrocytes
MAN1A1	Oligodendrocytes
MAN2C1	Oligodendrocytes
MAP2K1	Oligodendrocytes
MAP3K10	Oligodendrocytes
MAP7D2	Oligodendrocytes
MAPRE1	Oligodendrocytes
MAZ	Oligodendrocytes
MCM4	Oligodendrocytes
MED16	Oligodendrocytes
MED28	Oligodendrocytes
MFN2	Oligodendrocytes
MFSD13A	Oligodendrocytes
MGAT1	Oligodendrocytes
MIB2	Oligodendrocytes
MIGA1	Oligodendrocytes
MINPP1	Oligodendrocytes
MLLT3	Oligodendrocytes
MLX	Oligodendrocytes
MORN4	Oligodendrocytes
MPP1	Oligodendrocytes
MRPL14	Oligodendrocytes
MRPL17	Oligodendrocytes
MRPL18	Oligodendrocytes
MRPL21	Oligodendrocytes
MRPL27	Oligodendrocytes
MRPL33	Oligodendrocytes
MRPL38	Oligodendrocytes
MRPL43	Oligodendrocytes
MRPS14	Oligodendrocytes
MRPS18A	Oligodendrocytes
MRPS22	Oligodendrocytes
MRPS26	Oligodendrocytes
MRTFB	Oligodendrocytes
MRTO4	Oligodendrocytes
MSRA	Oligodendrocytes
MT1G	Oligodendrocytes
MTDH	Oligodendrocytes
MTSS1	Oligodendrocytes
MUL1	Oligodendrocytes
MYO5A	Oligodendrocytes
N4BP2	Oligodendrocytes
NAA16	Oligodendrocytes
NAA60	Oligodendrocytes
NAGK	Oligodendrocytes
NAPG	Oligodendrocytes
NARS1	Oligodendrocytes
NCL	Oligodendrocytes
NCOA4	Oligodendrocytes
NCOA7	Oligodendrocytes
NDUFS4	Oligodendrocytes
NEDD4L	Oligodendrocytes
NEDD8	Oligodendrocytes
NGRN	Oligodendrocytes
NIP7	Oligodendrocytes
NIPAL3	Oligodendrocytes
NIPSNAP1	Oligodendrocytes
NLGN1	Oligodendrocytes
NOL9	Oligodendrocytes
NOLC1	Oligodendrocytes
NOP56	Oligodendrocytes
NRP2	Oligodendrocytes
NRXN2	Oligodendrocytes
NUDT3	Oligodendrocytes
NUDT9	Oligodendrocytes
OAZ2	Oligodendrocytes
OLA1	Oligodendrocytes
OSGEP	Oligodendrocytes
OST4	Oligodendrocytes
OSTM1	Oligodendrocytes
OXLD1	Oligodendrocytes
P4HA1	Oligodendrocytes
PAIP2	Oligodendrocytes
PAK3	Oligodendrocytes
PARD3B	Oligodendrocytes
PCDH15	Oligodendrocytes
PCGF6	Oligodendrocytes
PCLO	Oligodendrocytes
PDAP1	Oligodendrocytes
PDCD2	Oligodendrocytes
PDCL3	Oligodendrocytes
PDIA4	Oligodendrocytes
PER2	Oligodendrocytes
PGS1	Oligodendrocytes
PHACTR1	Oligodendrocytes
PHAX	Oligodendrocytes
PHLDB1	Oligodendrocytes
PKD1	Oligodendrocytes
PLA2G6	Oligodendrocytes
PLPP3	Oligodendrocytes
PMPCB	Oligodendrocytes
POLDIP2	Oligodendrocytes
POLR2D	Oligodendrocytes
POLR2J	Oligodendrocytes
POLR2J3	Oligodendrocytes
POLR2M	Oligodendrocytes
POM121C	Oligodendrocytes
POM121	Oligodendrocytes
PORCN	Oligodendrocytes
PPA2	Oligodendrocytes
PPFIA2	Oligodendrocytes
PPP1CB	Oligodendrocytes
PPP1R35	Oligodendrocytes
PPP1R9A	Oligodendrocytes
PPP3CB	Oligodendrocytes
PPTC7	Oligodendrocytes
PRAF2	Oligodendrocytes
PRDX6	Oligodendrocytes
PRKACA	Oligodendrocytes
PRKCSH	Oligodendrocytes
PRPF8	Oligodendrocytes
PRR12	Oligodendrocytes
PSIP1	Oligodendrocytes
PSMA2	Oligodendrocytes
PSMB1	Oligodendrocytes
PSMC2	Oligodendrocytes
PSMD6	Oligodendrocytes
PTPN1	Oligodendrocytes
PTPN12	Oligodendrocytes
PTPRK	Oligodendrocytes
PWP1	Oligodendrocytes
QARS1	Oligodendrocytes
RAB18	Oligodendrocytes
RAB24	Oligodendrocytes
RAB3IP	Oligodendrocytes
RANGAP1	Oligodendrocytes
RARS1	Oligodendrocytes
RBX1	Oligodendrocytes
RCAN2	Oligodendrocytes
RDX	Oligodendrocytes
REEP3	Oligodendrocytes
RFTN1	Oligodendrocytes
RIC8B	Oligodendrocytes
RMND5B	Oligodendrocytes
RNF126	Oligodendrocytes
RNF157	Oligodendrocytes
RNF220	Oligodendrocytes
RNF24	Oligodendrocytes
RNFT1	Oligodendrocytes
RNPS1	Oligodendrocytes
RPL6	Oligodendrocytes
RPP21	Oligodendrocytes
RPS6KA3	Oligodendrocytes
RRP1B	Oligodendrocytes
RRP9	Oligodendrocytes
RSRP1	Oligodendrocytes
RTN3	Oligodendrocytes
RTN4IP1	Oligodendrocytes
RTRAF	Oligodendrocytes
RUNDC3B	Oligodendrocytes
RUSC2	Oligodendrocytes
S100A1	Oligodendrocytes
SAE1	Oligodendrocytes
SCD	Oligodendrocytes
SDE2	Oligodendrocytes
SEC14L1	Oligodendrocytes
SELENOK	Oligodendrocytes
SELENOS	Oligodendrocytes
SEM1	Oligodendrocytes
SEMA6D	Oligodendrocytes
SERBP1	Oligodendrocytes
SERTAD2	Oligodendrocytes
SF3B2	Oligodendrocytes
SGSM3	Oligodendrocytes
SH3BGRL2	Oligodendrocytes
SH3GL2	Oligodendrocytes
SHKBP1	Oligodendrocytes
SIN3B	Oligodendrocytes
SIRT6	Oligodendrocytes
SLC15A2	Oligodendrocytes
SLC22A17	Oligodendrocytes
SLC25A19	Oligodendrocytes
SLC25A3	Oligodendrocytes
SLC35A1	Oligodendrocytes
SLC35B4	Oligodendrocytes
SLC3A2	Oligodendrocytes
SLC8A1	Oligodendrocytes
SLC9A3R2	Oligodendrocytes
SLIRP	Oligodendrocytes
SMIM14	Oligodendrocytes
SMPD4	Oligodendrocytes
SMYD2	Oligodendrocytes
SNAPC1	Oligodendrocytes
SNRK	Oligodendrocytes
SNRNP200	Oligodendrocytes
SNRPC	Oligodendrocytes
SNX14	Oligodendrocytes
SNX17	Oligodendrocytes
SORCS3	Oligodendrocytes
SORL1	Oligodendrocytes
SPATA7	Oligodendrocytes
SPG7	Oligodendrocytes
SPRED2	Oligodendrocytes
SPRYD7	Oligodendrocytes
SREK1IP1	Oligodendrocytes
SRPRA	Oligodendrocytes
SRRD	Oligodendrocytes
SSBP2	Oligodendrocytes
SSH2	Oligodendrocytes
SSU72	Oligodendrocytes
STARD5	Oligodendrocytes
STK40	Oligodendrocytes
STRN4	Oligodendrocytes
SUDS3	Oligodendrocytes
SUGP2	Oligodendrocytes
SUN1	Oligodendrocytes
SV2A	Oligodendrocytes
SYBU	Oligodendrocytes
SYN3	Oligodendrocytes
SYT11	Oligodendrocytes
TAOK1	Oligodendrocytes
TBC1D24	Oligodendrocytes
TBCC	Oligodendrocytes
TCAF1	Oligodendrocytes
TECR	Oligodendrocytes
TFDP1	Oligodendrocytes
TGOLN2	Oligodendrocytes
THRA	Oligodendrocytes
THSD7A	Oligodendrocytes
TIMM23	Oligodendrocytes
TIMM9	Oligodendrocytes
TLE4	Oligodendrocytes
TLN2	Oligodendrocytes
TMCO1	Oligodendrocytes
TMED3	Oligodendrocytes
TMED4	Oligodendrocytes
TMEM178B	Oligodendrocytes
TMEM199	Oligodendrocytes
TMEM203	Oligodendrocytes
TMEM223	Oligodendrocytes
TMEM259	Oligodendrocytes
TMEM59	Oligodendrocytes
TMEM9B	Oligodendrocytes
TMUB2	Oligodendrocytes
TRIAP1	Oligodendrocytes
TP53BP1	Oligodendrocytes
TSEN15	Oligodendrocytes
TSNAX-DISC1	Oligodendrocytes
TSR3	Oligodendrocytes
TTC19	Oligodendrocytes
TTYH1	Oligodendrocytes
TUBA1A	Oligodendrocytes
UAP1	Oligodendrocytes
UBA52	Oligodendrocytes
UBAC1	Oligodendrocytes
UBC	Oligodendrocytes
UBP1	Oligodendrocytes
UGCG	Oligodendrocytes
UGT8	Oligodendrocytes
UQCRC2	Oligodendrocytes
USE1	Oligodendrocytes
USP11	Oligodendrocytes
USP14	Oligodendrocytes
USP5	Oligodendrocytes
UTP15	Oligodendrocytes
VAPA	Oligodendrocytes
VARS1	Oligodendrocytes
VEGFA	Oligodendrocytes
VEGFB	Oligodendrocytes
VMP1	Oligodendrocytes
VPS28	Oligodendrocytes
VPS29	Oligodendrocytes
VPS35	Oligodendrocytes
WARS1	Oligodendrocytes
WBP4	Oligodendrocytes
WDR45B	Oligodendrocytes
WSB1	Oligodendrocytes
WSB2	Oligodendrocytes
XRCC6	Oligodendrocytes
YIPF3	Oligodendrocytes
YKT6	Oligodendrocytes
YRDC	Oligodendrocytes
YWHAE	Oligodendrocytes
ZBTB16	Oligodendrocytes
ZC3H15	Oligodendrocytes
ZCCHC17	Oligodendrocytes
ZCRB1	Oligodendrocytes
ZFAND1	Oligodendrocytes
ZNF22	Oligodendrocytes
ZNF467	Oligodendrocytes
ZNF608	Oligodendrocytes
ZNF777	Oligodendrocytes
ZNF878	Oligodendrocytes
ZNF700	Oligodendrocytes
ZNF878	Oligodendrocytes
ZNF700	Oligodendrocytes
ZMAT2	Oligodendrocytes
ZMAT3	Oligodendrocytes
ZMIZ2	Oligodendrocytes
ZNHIT1	Oligodendrocytes
ZRSR2	Oligodendrocytes
C1orf35	OPC
C1orf52	OPC
C1orf43	OPC
ACAT2	OPC
ACD	OPC
ADH5	OPC
AGAP2	OPC
AGFG2	OPC
AGGF1	OPC
AGPAT1	OPC
ANP32D	OPC
ANP32A	OPC
APP	OPC
APRT	OPC
ARL6IP4	OPC
ARPP21	OPC
SPCS3	OPC
SPCS3	OPC
ATP2B2	OPC
ATP5F1A	OPC
ATP6AP1	OPC
ATP6V1A	OPC
ATP6V1B2	OPC
ATP6V1G1	OPC
ATXN7L3B	OPC
BANF1	OPC
BAX	OPC
C18orf32	OPC
BCHE	OPC
BCR	OPC
BHLHE41	OPC
BLCAP	OPC
BLOC1S4	OPC
C1QL3	OPC
CACNB1	OPC
CALR	OPC
CAMK4	OPC
CAMKK2	OPC
CANX	OPC
CAPNS1	OPC
CCDC112	OPC
CCT5	OPC
CD200	OPC
POLR1G	OPC
CDC37	OPC
CDS2	OPC
CELF2	OPC
CELSR2	OPC
CENPB	OPC
CHD5	OPC
CHDH	OPC
CHMP1A	OPC
CHST2	OPC
CIAO2B	OPC
COPB2	OPC
COPS7A	OPC
CRLF2	OPC
CRTC1	OPC
CSTB	OPC
CTTNBP2	OPC
CWH43	OPC
CYP2J2	OPC
CYTH2	OPC
C9orf40	OPC
DAPK1	OPC
DCTN1	OPC
DDA1	OPC
DEGS1	OPC
DGCR6L	OPC
DGCR6	OPC
DGKE	OPC
DHRS7	OPC
DISP2	OPC
DMPK	OPC
DNAJC30	OPC
DNAJC9	OPC
DSEL	OPC
DTX3	OPC
DUSP26	OPC
DYNC1I1	OPC
EDF1	OPC
EEF1G	OPC
EID1	OPC
EIF1AX	OPC
EIF3D	OPC
EIF6	OPC
ENDOD1	OPC
ERG28	OPC
ETHE1	OPC
KIAA1217	OPC
FAM104B	OPC
FAM171B	OPC
FAM20C	OPC
FAM76A	OPC
FBXL6	OPC
FCHO1	OPC
FEZ1	OPC
FKRP	OPC
FLYWCH1	OPC
FN3K	OPC
FN3KRP	OPC
FRMPD4	OPC
FSD1	OPC
FUOM	OPC
FXR2	OPC
FZD3	OPC
GABARAP	OPC
GABRB3	OPC
GAD1	OPC
GDE1	OPC
GLMP	OPC
C11orf96	OPC
GMPR	OPC
GOLGB1	OPC
GPR149	OPC
GPS1	OPC
C12orf57	OPC
GRIA2	OPC
GRK6	OPC
GUK1	OPC
HCN2	OPC
HEPACAM	OPC
HEXD	OPC
HEY1	OPC
HRK	OPC
HS3ST1	OPC
HSBP1	OPC
HSPA12A	OPC
ICE1	OPC
IDH3G	OPC
IER3	OPC
IFT27	OPC
IL1RAPL2	OPC
ITPA	OPC
KBTBD11	OPC
KCNAB1	OPC
KCNC1	OPC
KCNK1	OPC
KCNQ5	OPC
KIF5A	OPC
KIF5C	OPC
KLC1	OPC
KLHL9	OPC
L1CAM	OPC
LAMTOR2	OPC
LMAN2	OPC
LMTK3	OPC
LPGAT1	OPC
LRFN3	OPC
LRP1	OPC
LRRC42	OPC
LRRK2	OPC
LRRN3	OPC
LRTM2	OPC
LSM14B	OPC
LSM4	OPC
LUC7L3	OPC
MAP7D1	OPC
MAST3	OPC
MAT2B	OPC
MATR3	OPC
MBP	OPC
MEAF6	OPC
MFGE8	OPC
MFN2	OPC
MINK1	OPC
MOGS	OPC
MRPL17	OPC
MRPL30	OPC
MRPL43	OPC
MRPL51	OPC
MRPS12	OPC
MRPS18C	OPC
MRPS21	OPC
MRPS24	OPC
MRTFB	OPC
MSL3	OPC
MSRB1	OPC
MYDGF	OPC
MYG1	OPC
NARS1	OPC
NBDY	OPC
NCL	OPC
NDFIP1	OPC
NDUFB2	OPC
NDUFS2	OPC
NELL2	OPC
NFU1	OPC
NIFK	OPC
NPDC1	OPC
NR4A1	OPC
NR4A3	OPC
NRBF2	OPC
NT5E	OPC
NTNG2	OPC
NUP93	OPC
NUS1	OPC
ORAI2	OPC
ORMDL3	OPC
OSBPL8	OPC
OSTC	OPC
PAK1IP1	OPC
PALMD	OPC
PAX6	OPC
PCDHGA7	OPC
PCNA	OPC
PDE10A	OPC
PDE1A	OPC
PDE2A	OPC
PDIA3	OPC
PDIA6	OPC
PGRMC2	OPC
PHF23	OPC
PIGT	OPC
PIM3	OPC
PJA2	OPC
PLRG1	OPC
PMEPA1	OPC
PNRC1	OPC
POM121C	OPC
POM121	OPC
POP7	OPC
POU6F2	OPC
PPID	OPC
PPP2R1A	OPC
PPP3CA	OPC
PPT1	OPC
PRDX2	OPC
PRKAR1B	OPC
PRKAR2B	OPC
PRKCG	OPC
PRMT1	OPC
PRPF8	OPC
PSENEN	OPC
PSMA2	OPC
PSMB1	OPC
PSMB7	OPC
PSMD2	OPC
PSMD4	OPC
PTOV1	OPC
PTPN11	OPC
RAB5IF	OPC
TGIF2-RAB5IF	OPC
RADIL	OPC
RANBP2	OPC
RBFA	OPC
RPAP3	OPC
RPGRIP1	OPC
RPL4	OPC
RPS9	OPC
RUNDC3A	OPC
SAR1B	OPC
SARS1	OPC
SART1	OPC
SCD	OPC
SEC14L1	OPC
SECISBP2	OPC
SELENOF	OPC
SELENOS	OPC
SETSIP	OPC
SF3B2	OPC
SGTB	OPC
SH3GLB2	OPC
SHISA5	OPC
SLC22A17	OPC
SLC25A29	OPC
SLC35B1	OPC
SLC39A1	OPC
SLC39A10	OPC
SLC5A3	OPC
SLU7	OPC
SMIM7	OPC
SNRNP70	OPC
SNRPF	OPC
SNX17	OPC
SPHK2	OPC
SPTB	OPC
SPTBN1	OPC
SQLE	OPC
SQSTM1	OPC
SRP72	OPC
SRP9	OPC
SSBP4	OPC
SSR1	OPC
ST3GAL5	OPC
STARD5	OPC
STK32A	OPC
STRN	OPC
STUB1	OPC
SUCLG1	OPC
SULT4A1	OPC
SYNM	OPC
SYPL1	OPC
SYVN1	OPC
TCEAL8	OPC
TCF25	OPC
TM2D3	OPC
TMBIM4	OPC
TMED2	OPC
TMEM109	OPC
TMEM222	OPC
TMEM240	OPC
TMEM259	OPC
TMEM50A	OPC
TMEM59	OPC
TOMM6	OPC
TRAPPC6A	OPC
TRIM28	OPC
TRIM37	OPC
TSPYL5	OPC
TTLL7	OPC
TXN	OPC
TXNL1	OPC
UPF3A	OPC
UQCRC2	OPC
VKORC1	OPC
VMA21	OPC
WASF1	OPC
WDR41	OPC
YJEFN3	OPC
YRDC	OPC
YWHAE	OPC
YWHAG	OPC
YWHAQ	OPC
ZBTB7A	OPC
ZDHHC23	OPC
ZNF365	OPC
ZNF385B	OPC
ZNHIT3	OPC
